CED,AGEP,Citizens_ERP,Enrolled,Under_enrollment_n,Under_enrollment_proportion
Durack,25-29,12964,8281,4683,36.1%
Durack,30-34,13816,9711,4105,29.7%
Melbourne,20-24,13577,9699,3878,28.6%
Sydney,20-24,10529,7062,3467,32.9%
Durack,20-24,9517,6189,3328,35.0%
Sydney,25-29,18143,15323,2820,15.5%
Durack,40-44,12130,9389,2741,22.6%
Durack,35-39,12060,9390,2670,22.1%
Herbert,20-24,13674,11133,2541,18.6%
Melbourne,25-29,20195,17662,2533,12.5%
Ryan,18-19,5721,3275,2446,42.8%
Lingiari,20-24,8171,5796,2375,29.1%
Herbert,18-19,4906,2601,2305,47.0%
Melbourne,18-19,3689,1482,2207,59.8%
Durack,50-54,11620,9445,2175,18.7%
Brisbane,20-24,13745,11629,2116,15.4%
Melbourne Ports,25-29,12994,10975,2019,15.5%
Lingiari,18-19,2941,1017,1924,65.4%
Durack,45-49,11838,9965,1873,15.8%
Wakefield,18-19,4284,2479,1805,42.1%
Batman,20-24,9611,7927,1684,17.5%
Chisholm,18-19,3941,2293,1648,41.8%
Leichhardt,18-19,3730,2104,1626,43.6%
Wills,20-24,10727,9114,1613,15.0%
Canberra,18-19,5538,3932,1606,29.0%
Durack,18-19,3226,1622,1604,49.7%
Gorton,18-19,4571,2982,1589,34.8%
Melbourne Ports,20-24,8112,6525,1587,19.6%
Calwell,18-19,4679,3133,1546,33.0%
Kennedy,20-24,8248,6705,1543,18.7%
McEwen,18-19,5028,3506,1522,30.3%
Kingsford Smith,20-24,9907,8387,1520,15.3%
Leichhardt,20-24,9758,8274,1484,15.2%
Forde,18-19,3985,2510,1475,37.0%
Capricornia,20-24,9153,7690,1463,16.0%
Durack,55-59,10575,9121,1454,13.7%
Port Adelaide,18-19,3977,2524,1453,36.5%
Holt,18-19,4606,3155,1451,31.5%
Barker,18-19,3259,1811,1448,44.4%
Wright,18-19,4014,2568,1446,36.0%
Kennedy,18-19,3116,1674,1442,46.3%
Wakefield,20-24,11384,9947,1437,12.6%
Sydney,18-19,2462,1033,1429,58.0%
Blair,18-19,3889,2462,1427,36.7%
Ryan,20-24,12839,11413,1426,11.1%
Solomon,25-29,9088,7690,1398,15.4%
Rankin,18-19,4158,2793,1365,32.8%
Lalor,18-19,4496,3139,1357,30.2%
Griffith,20-24,12178,10833,1345,11.0%
Longman,18-19,3932,2592,1340,34.1%
Lingiari,25-29,9031,7691,1340,14.8%
Adelaide,18-19,3489,2152,1337,38.3%
Mayo,18-19,3160,1833,1327,42.0%
Cunningham,18-19,4248,2925,1323,31.1%
Oxley,18-19,3941,2624,1317,33.4%
La Trobe,18-19,4423,3124,1299,29.4%
Dawson,20-24,9413,8115,1298,13.8%
Ballarat,18-19,3942,2648,1294,32.8%
Brisbane,18-19,3701,2413,1288,34.8%
Perth,20-24,8347,7062,1285,15.4%
Higgins,20-24,9475,8192,1283,13.5%
Batman,18-19,3067,1786,1281,41.8%
Swan,20-24,10075,8799,1276,12.7%
Scullin,18-19,4108,2833,1275,31.0%
Solomon,20-24,7107,5832,1275,17.9%
Capricornia,25-29,9560,8299,1261,13.2%
Werriwa,18-19,4932,3681,1251,25.4%
Fowler,18-19,3972,2734,1238,31.2%
Kennedy,30-34,8350,7115,1235,14.8%
Dawson,18-19,3400,2188,1212,35.7%
Maribyrnong,18-19,3479,2273,1206,34.7%
Casey,18-19,3624,2419,1205,33.2%
Fenner,20-24,13648,12449,1199,8.8%
Lindsay,18-19,4333,3135,1198,27.6%
Fadden,18-19,3870,2673,1197,30.9%
Swan,18-19,3289,2094,1195,36.3%
Corangamite,18-19,3689,2497,1192,32.3%
O'Connor,25-29,8334,7144,1190,14.3%
McMillan,18-19,3786,2599,1187,31.4%
Kennedy,40-44,9194,8013,1181,12.8%
Grey,18-19,2744,1568,1176,42.8%
Blair,20-24,10366,9196,1170,11.3%
Moncrieff,20-24,9569,8400,1169,12.2%
Capricornia,18-19,3461,2294,1167,33.7%
Makin,18-19,3627,2461,1166,32.2%
Newcastle,18-19,3873,2707,1166,30.1%
Chifley,18-19,4502,3337,1165,25.9%
Brand,20-24,10378,9213,1165,11.2%
Moncrieff,18-19,3217,2056,1161,36.1%
Grayndler,20-24,8280,7119,1161,14.0%
Grey,25-29,7980,6823,1157,14.5%
Grey,20-24,7386,6232,1154,15.6%
Fenner,18-19,4564,3416,1148,25.2%
Adelaide,20-24,10148,9011,1137,11.2%
Bonner,18-19,3787,2651,1136,30.0%
Kennedy,25-29,8385,7256,1129,13.5%
Moreton,18-19,3653,2528,1125,30.8%
Isaacs,18-19,3491,2367,1124,32.2%
Corio,18-19,3547,2424,1123,31.7%
Kingsford Smith,18-19,3465,2344,1121,32.4%
Boothby,18-19,3608,2487,1121,31.1%
Gellibrand,18-19,3018,1900,1118,37.0%
Newcastle,20-24,12561,11444,1117,8.9%
Bendigo,18-19,3643,2532,1111,30.5%
Capricornia,30-34,9779,8674,1105,11.3%
Leichhardt,25-29,10338,9241,1097,10.6%
Blaxland,18-19,4085,2993,1092,26.7%
Kooyong,18-19,3693,2602,1091,29.5%
Cowan,18-19,3839,2751,1088,28.3%
Flinders,18-19,3421,2334,1087,31.8%
Watson,18-19,3893,2808,1085,27.9%
Wills,18-19,2953,1869,1084,36.7%
Perth,25-29,10812,9731,1081,10.0%
Oxley,20-24,10013,8933,1080,10.8%
Griffith,18-19,3430,2351,1079,31.4%
Kingston,18-19,3394,2324,1070,31.5%
Riverina,18-19,4015,2950,1065,26.5%
Flynn,50-54,10591,9533,1058,10.0%
Groom,18-19,3637,2580,1057,29.1%
Aston,18-19,3491,2439,1052,30.1%
Flynn,18-19,3118,2069,1049,33.7%
McPherson,18-19,3444,2395,1049,30.5%
Brand,18-19,3732,2689,1043,28.0%
Pearce,18-19,4156,3114,1042,25.1%
McMahon,18-19,4014,2976,1038,25.9%
Capricornia,50-54,9908,8871,1037,10.5%
Grey,30-34,7826,6795,1031,13.2%
Gorton,20-24,11485,10460,1025,8.9%
Farrer,18-19,3815,2796,1019,26.7%
Indi,18-19,3122,2114,1008,32.3%
Flynn,25-29,9239,8233,1006,10.9%
Hindmarsh,18-19,3179,2175,1004,31.6%
Flynn,20-24,8540,7552,988,11.6%
Hotham,18-19,3082,2096,986,32.0%
Forde,20-24,10124,9138,986,9.7%
Burt,18-19,3926,2942,984,25.1%
Denison,18-19,2478,1495,983,39.7%
Bruce,18-19,3168,2194,974,30.7%
Herbert,25-29,11934,10961,973,8.2%
Jagajaga,18-19,3328,2356,972,29.2%
Wakefield,25-29,11040,10071,969,8.8%
New England,18-19,3914,2951,963,24.6%
Dickson,18-19,3700,2738,962,26.0%
Calare,18-19,3982,3022,960,24.1%
Gorton,25-29,11837,10877,960,8.1%
Capricornia,40-44,9247,8291,956,10.3%
Bowman,18-19,3565,2610,955,26.8%
Kennedy,50-54,10262,9307,955,9.3%
Petrie,18-19,3432,2478,954,27.8%
Gippsland,18-19,3034,2088,946,31.2%
Dunkley,18-19,3201,2261,940,29.4%
Macarthur,18-19,4248,3309,939,22.1%
Barker,20-24,7387,6449,938,12.7%
Dawson,25-29,9494,8561,933,9.8%
Flynn,30-34,9861,8931,930,9.4%
Gellibrand,20-24,8662,7733,929,10.7%
Fisher,18-19,3200,2277,923,28.8%
Bennelong,18-19,3507,2584,923,26.3%
Barker,40-44,8604,7682,922,10.7%
Lilley,18-19,3258,2351,907,27.8%
Deakin,18-19,3077,2174,903,29.3%
Solomon,18-19,2255,1352,903,40.0%
Parkes,50-54,10163,9265,898,8.8%
Chisholm,20-24,9257,8361,896,9.7%
Moore,18-19,3815,2929,886,23.2%
Bass,18-19,2605,1721,884,33.9%
Farrer,40-44,9205,8322,883,9.6%
Murray,18-19,3335,2453,882,26.4%
O'Connor,30-34,8455,7586,869,10.3%
Longman,20-24,9647,8784,863,8.9%
Reid,18-19,3133,2275,858,27.4%
Canning,18-19,3287,2432,855,26.0%
Dawson,30-34,9521,8677,844,8.9%
Holt,20-24,12141,11300,841,6.9%
Herbert,30-34,10976,10136,840,7.6%
Flynn,40-44,9770,8930,840,8.6%
Menzies,18-19,3440,2601,839,24.4%
Sturt,18-19,3205,2366,839,26.2%
Farrer,25-29,8455,7617,838,9.9%
Farrer,30-34,8244,7411,833,10.1%
Greenway,18-19,3880,3048,832,21.4%
Oxley,30-34,10101,9272,829,8.2%
Pearce,20-24,10371,9546,825,8.0%
Hunter,18-19,3909,3085,824,21.1%
Perth,18-19,2606,1784,822,31.5%
Blair,25-29,10297,9480,817,7.9%
Port Adelaide,20-24,10316,9501,815,7.9%
O'Connor,18-19,3081,2268,813,26.4%
Hinkler,18-19,2815,2003,812,28.9%
Barton,18-19,3135,2327,808,25.8%
Parramatta,18-19,3273,2466,807,24.7%
Maribyrnong,20-24,9936,9131,805,8.1%
O'Connor,40-44,9012,8209,803,8.9%
Kennedy,45-49,9898,9095,803,8.1%
Hasluck,18-19,3293,2491,802,24.4%
Grey,40-44,8006,7205,801,10.0%
Dawson,40-44,9835,9036,799,8.1%
Lyons,18-19,2226,1428,798,35.9%
Mallee,18-19,3014,2217,797,26.4%
Oxley,25-29,9560,8769,791,8.3%
Lilley,20-24,9728,8941,787,8.1%
Curtin,18-19,3282,2500,782,23.8%
Banks,18-19,3424,2650,774,22.6%
Brand,25-29,10672,9905,767,7.2%
Macquarie,18-19,3580,2817,763,21.3%
Durack,60-64,8423,7660,763,9.1%
Higgins,18-19,2770,2009,761,27.5%
Fremantle,18-19,3224,2470,754,23.4%
Wide Bay,18-19,2722,1968,754,27.7%
O'Connor,20-24,7407,6659,748,10.1%
Parkes,18-19,3309,2564,745,22.5%
Wannon,18-19,3085,2345,740,24.0%
Flynn,45-49,10210,9479,731,7.2%
Dobell,18-19,3806,3078,728,19.1%
Barker,30-34,7475,6749,726,9.7%
Longman,30-34,8887,8163,724,8.2%
Wright,40-44,10386,9662,724,7.0%
Dawson,50-54,10457,9738,719,6.9%
Farrer,50-54,10257,9548,709,6.9%
Tangney,18-19,3472,2769,703,20.3%
Barker,25-29,7210,6513,697,9.7%
Whitlam,18-19,3790,3094,696,18.4%
Goldstein,18-19,3172,2480,692,21.8%
Wakefield,40-44,9588,8898,690,7.2%
Maranoa,40-44,8633,7943,690,8.0%
Eden-Monaro,18-19,3151,2462,689,21.9%
Melbourne Ports,18-19,2002,1316,686,34.3%
Shortland,18-19,3519,2833,686,19.5%
Hume,18-19,3796,3121,675,17.8%
Lindsay,20-24,11617,10943,674,5.8%
Wright,30-34,8030,7367,663,8.3%
Mitchell,18-19,3772,3110,662,17.6%
Maranoa,25-29,7789,7127,662,8.5%
Parkes,40-44,8648,7989,659,7.6%
Herbert,40-44,9957,9299,658,6.6%
Paterson,18-19,3634,2977,657,18.1%
Denison,20-24,6672,6016,656,9.8%
Franklin,18-19,2288,1634,654,28.6%
Wright,20-24,8385,7732,653,7.8%
Hughes,18-19,3622,2970,652,18.0%
Rankin,20-24,10171,9519,652,6.4%
Cunningham,20-24,11067,10418,649,5.9%
Berowra,18-19,3990,3347,643,16.1%
Lindsay,25-29,12049,11415,634,5.3%
Reid,20-24,8513,7880,633,7.4%
Burt,20-24,9819,9187,632,6.4%
Blair,30-34,10332,9701,631,6.1%
Fairfax,18-19,3135,2504,631,20.1%
Maranoa,18-19,2960,2334,626,21.2%
Mayo,40-44,8517,7893,624,7.3%
Kennedy,35-39,7912,7290,622,7.9%
Stirling,18-19,2655,2035,620,23.4%
Forde,25-29,9792,9175,617,6.3%
Lingiari,30-34,8724,8111,613,7.0%
Capricornia,35-39,8844,8232,612,6.9%
Pearce,25-29,11141,10531,610,5.5%
Page,50-54,11002,10393,609,5.5%
Moreton,20-24,9871,9264,607,6.2%
Oxley,40-44,9884,9277,607,6.1%
New England,40-44,8710,8103,607,7.0%
Leichhardt,50-54,11149,10543,606,5.4%
Hindmarsh,20-24,9215,8609,606,6.6%
Barker,45-49,9831,9225,606,6.2%
Grey,50-54,9738,9134,604,6.2%
Maranoa,30-34,7690,7092,598,7.8%
Indi,40-44,8292,7695,597,7.2%
Fowler,20-24,10577,9984,593,5.6%
Richmond,18-19,2875,2282,593,20.6%
Braddon,18-19,2235,1643,592,26.5%
O'Connor,50-54,10102,9511,591,5.9%
North Sydney,25-29,9449,8859,590,6.2%
Maranoa,50-54,9776,9186,590,6.0%
Gippsland,50-54,9302,8713,589,6.3%
Makin,20-24,9060,8471,589,6.5%
Robertson,18-19,3317,2729,588,17.7%
Kingston,20-24,9135,8548,587,6.4%
Gorton,30-34,13364,12781,583,4.4%
Calare,20-24,9541,8959,582,6.1%
Page,18-19,3521,2940,581,16.5%
Ballarat,20-24,10055,9475,580,5.8%
Solomon,30-34,8663,8085,578,6.7%
Bendigo,20-24,9297,8720,577,6.2%
Capricornia,45-49,9631,9055,576,6.0%
McMahon,20-24,10518,9943,575,5.5%
Gellibrand,25-29,10014,9439,575,5.7%
Bass,20-24,6671,6097,574,8.6%
Leichhardt,30-34,10270,9701,569,5.5%
Reid,25-29,9762,9193,569,5.8%
Calare,40-44,9512,8943,569,6.0%
Longman,25-29,8910,8348,562,6.3%
Dawson,45-49,10301,9743,558,5.4%
Melbourne Ports,30-34,13693,13135,558,4.1%
Dawson,35-39,8948,8395,553,6.2%
Mallee,50-54,9128,8578,550,6.0%
Cook,18-19,3031,2482,549,18.1%
Wide Bay,40-44,8208,7660,548,6.7%
Gilmore,18-19,2998,2451,547,18.3%
Lalor,20-24,11441,10895,546,4.8%
Parramatta,25-29,9404,8860,544,5.8%
Kooyong,20-24,9964,9424,540,5.4%
Wentworth,20-24,6457,5920,537,8.3%
Hasluck,20-24,8104,7570,534,6.6%
Longman,40-44,9393,8862,531,5.7%
Forrest,18-19,2930,2400,530,18.1%
Calare,50-54,10242,9713,529,5.2%
Swan,25-29,10321,9793,528,5.1%
Calwell,20-24,11482,10955,527,4.6%
Parramatta,20-24,8601,8075,526,6.1%
Brisbane,25-29,14794,14268,526,3.6%
Farrer,45-49,9780,9255,525,5.4%
Wannon,40-44,7598,7075,523,6.9%
Riverina,50-54,9750,9230,520,5.3%
Lalor,25-29,12068,11548,520,4.3%
Cowper,18-19,3248,2729,519,16.0%
New England,50-54,9719,9204,515,5.3%
Calare,25-29,9366,8853,513,5.5%
Maranoa,20-24,7724,7212,512,6.6%
Barker,35-39,7543,7033,510,6.8%
O'Connor,45-49,9775,9272,503,5.1%
Mallee,40-44,7432,6929,503,6.8%
Grey,45-49,9213,8712,501,5.4%
Forde,40-44,9727,9231,496,5.1%
O'Connor,35-39,8045,7550,495,6.2%
Petrie,20-24,8923,8431,492,5.5%
McEwen,25-29,13045,12554,491,3.8%
Barker,50-54,9949,9461,488,4.9%
Kennedy,55-59,10315,9832,483,4.7%
Rankin,25-29,9937,9463,474,4.8%
Groom,20-24,9261,8790,471,5.1%
Blair,40-44,9137,8666,471,5.2%
Leichhardt,40-44,11240,10770,470,4.2%
Murray,40-44,8060,7590,470,5.8%
Flynn,35-39,8982,8513,469,5.2%
Stirling,25-29,8797,8331,466,5.3%
Gippsland,40-44,7713,7251,462,6.0%
Grey,35-39,7153,6693,460,6.4%
Grayndler,18-19,1887,1428,459,24.3%
Indi,50-54,9564,9106,458,4.8%
Murray,50-54,9437,8981,456,4.8%
Hinkler,30-34,6232,5778,454,7.3%
Corio,20-24,9490,9038,452,4.8%
Wannon,50-54,9184,8732,452,4.9%
Hinkler,20-24,6525,6074,451,6.9%
Mackellar,18-19,3136,2686,450,14.4%
Gorton,40-44,13635,13186,449,3.3%
Mallee,45-49,8519,8071,448,5.3%
Hinkler,40-44,7456,7008,448,6.0%
Wide Bay,30-34,5979,5531,448,7.5%
Hinkler,50-54,8567,8122,445,5.2%
Higgins,25-29,11596,11156,440,3.8%
Wannon,45-49,8634,8195,439,5.1%
Fadden,20-24,9756,9318,438,4.5%
Groom,40-44,8595,8162,433,5.0%
Moncrieff,25-29,9261,8829,432,4.7%
Eden-Monaro,40-44,9306,8879,427,4.6%
Fremantle,20-24,8217,7791,426,5.2%
Wide Bay,50-54,9877,9452,425,4.3%
Solomon,40-44,7104,6679,425,6.0%
McEwen,20-24,12098,11674,424,3.5%
Cowper,50-54,10242,9825,417,4.1%
Herbert,50-54,9176,8759,417,4.5%
Canberra,20-24,12981,12570,411,3.2%
Denison,40-44,6091,5683,408,6.7%
Moncrieff,40-44,8444,8036,408,4.8%
Burt,25-29,9868,9461,407,4.1%
Maranoa,35-39,7589,7184,405,5.3%
Lyne,50-54,9688,9283,405,4.2%
Lyne,18-19,2894,2491,403,13.9%
Moncrieff,50-54,8640,8238,402,4.6%
Lingiari,45-49,7848,7447,401,5.1%
Cowper,40-44,8635,8235,400,4.6%
Farrer,35-39,8050,7655,395,4.9%
Hinkler,25-29,6164,5770,394,6.4%
Canning,40-44,7874,7481,393,5.0%
Forde,30-34,9865,9474,391,4.0%
Maranoa,45-49,9256,8865,391,4.2%
Brand,30-34,10673,10283,390,3.7%
Wright,25-29,7173,6783,390,5.4%
Parkes,45-49,9394,9008,386,4.1%
Leichhardt,35-39,10220,9836,384,3.8%
Port Adelaide,25-29,10248,9866,382,3.7%
Blaxland,20-24,10214,9833,381,3.7%
Bruce,20-24,7981,7602,379,4.8%
Gippsland,45-49,8570,8191,379,4.4%
Curtin,20-24,8133,7755,378,4.7%
Bass,40-44,5921,5544,377,6.4%
Wide Bay,25-29,5645,5271,374,6.6%
Lingiari,40-44,7544,7172,372,4.9%
McMillan,40-44,9401,9030,371,3.9%
Farrer,55-59,11014,10646,368,3.3%
Casey,40-44,9142,8774,368,4.0%
Richmond,50-54,10065,9698,367,3.6%
Corio,40-44,8984,8618,366,4.1%
Riverina,40-44,8643,8282,361,4.2%
Bradfield,18-19,3732,3371,361,9.7%
McEwen,40-44,14089,13729,360,2.6%
North Sydney,18-19,2401,2041,360,15.0%
Page,40-44,9072,8714,358,3.9%
Watson,20-24,9566,9211,355,3.7%
Wright,35-39,8738,8385,353,4.0%
Lingiari,50-54,7215,6865,350,4.9%
North Sydney,20-24,7233,6885,348,4.8%
Petrie,40-44,9762,9420,342,3.5%
Scullin,20-24,10353,10012,341,3.3%
Wide Bay,20-24,6109,5771,338,5.5%
Blair,50-54,8945,8609,336,3.8%
McEwen,30-34,14472,14136,336,2.3%
Franklin,40-44,6449,6113,336,5.2%
Maranoa,55-59,9980,9647,333,3.3%
Lyons,30-34,5112,4780,332,6.5%
Mayo,20-24,6654,6323,331,5.0%
Fadden,40-44,9692,9361,331,3.4%
Parkes,55-59,10512,10183,329,3.1%
Bendigo,50-54,9714,9386,328,3.4%
Flinders,40-44,9099,8773,326,3.6%
Parkes,25-29,9341,9016,325,3.5%
Port Adelaide,40-44,9691,9366,325,3.4%
Forrest,40-44,9270,8945,325,3.5%
Lyons,40-44,5952,5634,318,5.3%
Gilmore,50-54,9482,9172,310,3.3%
Pearce,40-44,10691,10383,308,2.9%
Hume,40-44,10065,9758,307,3.1%
Wakefield,45-49,10299,9993,306,3.0%
Wills,25-29,13265,12960,305,2.3%
Wentworth,25-29,9698,9398,300,3.1%
Herbert,35-39,9394,9096,298,3.2%
Isaacs,20-24,8607,8310,297,3.5%
Lyne,40-44,7635,7339,296,3.9%
Lilley,40-44,10134,9838,296,2.9%
Cowan,20-24,8632,8339,293,3.4%
Wright,50-54,10472,10180,292,2.8%
Ballarat,40-44,9503,9211,292,3.1%
Wakefield,35-39,8961,8670,291,3.2%
Dickson,40-44,10303,10012,291,2.8%
Eden-Monaro,50-54,10552,10261,291,2.8%
Mayo,35-39,6856,6566,290,4.2%
Denison,50-54,6446,6157,289,4.5%
Wannon,35-39,6456,6168,288,4.5%
Longman,35-39,8491,8203,288,3.4%
Isaacs,40-44,10513,10227,286,2.7%
Bennelong,20-24,8959,8676,283,3.2%
Fisher,40-44,8358,8075,283,3.4%
Bendigo,40-44,9051,8770,281,3.1%
Isaacs,25-29,8363,8082,281,3.4%
Denison,25-29,6324,6044,280,4.4%
Hasluck,40-44,8442,8162,280,3.3%
Riverina,20-24,9686,9411,275,2.8%
Macarthur,20-24,11098,10825,273,2.5%
Richmond,40-44,8974,8708,266,3.0%
Holt,25-29,11776,11511,265,2.3%
Kennedy,65-69,8492,8230,262,3.1%
Hotham,20-24,7774,7512,262,3.4%
Lyons,50-54,7373,7114,259,3.5%
Dunkley,40-44,9019,8760,259,2.9%
Durack,65-69,6324,6065,259,4.1%
Groom,50-54,8694,8436,258,3.0%
Petrie,25-29,8689,8431,258,3.0%
Brisbane,40-44,10139,9882,257,2.5%
Stirling,20-24,7280,7025,255,3.5%
Parkes,65-69,8315,8060,255,3.1%
Maribyrnong,40-44,9883,9630,253,2.6%
Makin,25-29,8644,8392,252,2.9%
Moncrieff,45-49,8850,8599,251,2.8%
Lingiari,35-39,7643,7393,250,3.3%
Lilley,25-29,10022,9774,248,2.5%
Canning,20-24,7678,7431,247,3.2%
Fowler,50-54,9700,9453,247,2.5%
Hunter,40-44,9574,9327,247,2.6%
Braddon,40-44,5545,5298,247,4.5%
Murray,45-49,8898,8651,247,2.8%
Macquarie,40-44,9160,8914,246,2.7%
Herbert,45-49,9806,9560,246,2.5%
Mallee,35-39,6493,6249,244,3.8%
Hinkler,45-49,7984,7741,243,3.0%
Gippsland,25-29,7547,7308,239,3.2%
Lyons,25-29,4807,4569,238,4.9%
Forrest,30-34,7900,7665,235,3.0%
Bass,30-34,5504,5269,235,4.3%
New England,20-24,8754,8520,234,2.7%
Wide Bay,35-39,6651,6417,234,3.5%
Kingston,25-29,9190,8957,233,2.5%
Gilmore,40-44,7870,7637,233,3.0%
Brand,40-44,9281,9049,232,2.5%
Ballarat,50-54,9892,9664,228,2.3%
Rankin,30-34,10564,10338,226,2.1%
Dickson,30-34,8534,8309,225,2.6%
Farrer,20-24,8877,8652,225,2.5%
Port Adelaide,30-34,10824,10600,224,2.1%
Mallee,30-34,6639,6415,224,3.4%
Werriwa,20-24,11630,11406,224,1.9%
Mayo,30-34,6081,5860,221,3.6%
Rankin,40-44,9509,9288,221,2.3%
Parkes,30-34,8615,8397,218,2.5%
Boothby,20-24,8790,8572,218,2.5%
Riverina,30-34,8260,8043,217,2.6%
Gorton,35-39,13940,13725,215,1.5%
Franklin,30-34,5907,5693,214,3.6%
Grayndler,25-29,11351,11137,214,1.9%
Hasluck,25-29,7568,7356,212,2.8%
Richmond,30-34,6959,6747,212,3.0%
Capricornia,55-59,9431,9219,212,2.2%
Braddon,50-54,6675,6463,212,3.2%
Longman,45-49,9620,9409,211,2.2%
Parkes,35-39,7873,7663,210,2.7%
Wright,45-49,10791,10582,209,1.9%
Gippsland,30-34,7550,7342,208,2.8%
Calare,30-34,8970,8763,207,2.3%
Hasluck,30-34,8067,7860,207,2.6%
Batman,25-29,10894,10688,206,1.9%
Greenway,25-29,8897,8695,202,2.3%
Aston,20-24,8987,8788,199,2.2%
Petrie,30-34,9418,9220,198,2.1%
Kooyong,40-44,7749,7551,198,2.6%
Calare,45-49,10109,9913,196,1.9%
La Trobe,40-44,11114,10918,196,1.8%
Paterson,50-54,9561,9366,195,2.0%
Franklin,25-29,5245,5050,195,3.7%
Groom,25-29,8816,8622,194,2.2%
Wakefield,30-34,10534,10340,194,1.8%
Gippsland,35-39,7098,6907,191,2.7%
Wentworth,18-19,1957,1767,190,9.7%
Shortland,40-44,8600,8410,190,2.2%
Blair,45-49,9145,8955,190,2.1%
Groom,45-49,9083,8893,190,2.1%
Dobell,40-44,9195,9005,190,2.1%
Gippsland,20-24,7630,7441,189,2.5%
Richmond,25-29,6147,5959,188,3.1%
Robertson,40-44,8534,8348,186,2.2%
Werriwa,40-44,10816,10633,183,1.7%
Lyons,45-49,6876,6694,182,2.7%
Fremantle,25-29,8881,8699,182,2.0%
Fowler,40-44,8789,8608,181,2.1%
Maranoa,65-69,9184,9005,179,2.0%
Dunkley,20-24,8352,8173,179,2.1%
Oxley,35-39,9546,9368,178,1.9%
Farrer,65-69,9538,9366,172,1.8%
Makin,40-44,9206,9034,172,1.9%
Warringah,18-19,2567,2397,170,6.6%
McPherson,20-24,8289,8120,169,2.0%
Lindsay,40-44,10644,10475,169,1.6%
Franklin,50-54,6744,6577,167,2.5%
Chisholm,40-44,8053,7886,167,2.1%
Barton,20-24,8348,8182,166,2.0%
Parramatta,50-54,8582,8418,164,1.9%
Mayo,50-54,9349,9187,162,1.7%
Hinkler,35-39,6410,6252,158,2.5%
McMillan,50-54,9903,9745,158,1.6%
Longman,50-54,9244,9087,157,1.7%
Oxley,45-49,9608,9451,157,1.6%
Blair,35-39,8734,8578,156,1.8%
Higgins,40-44,8682,8526,156,1.8%
Solomon,35-39,7494,7338,156,2.1%
Forde,35-39,9293,9140,153,1.6%
Brisbane,50-54,8737,8588,149,1.7%
Bowman,40-44,8788,8640,148,1.7%
Lingiari,55-59,6119,5972,147,2.4%
Forde,50-54,8237,8091,146,1.8%
Hughes,20-24,8864,8719,145,1.6%
Canberra,25-29,13010,12865,145,1.1%
Bass,50-54,6468,6325,143,2.2%
Eden-Monaro,20-24,7111,6968,143,2.0%
Oxley,50-54,8709,8566,143,1.6%
Wide Bay,45-49,9157,9015,142,1.6%
Fenner,25-29,14481,14340,141,1.0%
Melbourne Ports,50-54,7975,7835,140,1.8%
Calare,35-39,8491,8351,140,1.6%
Moncrieff,30-34,8496,8358,138,1.6%
Mallee,25-29,7197,7059,138,1.9%
Macarthur,25-29,10995,10859,136,1.2%
Curtin,40-44,7800,7665,135,1.7%
Parkes,20-24,8761,8627,134,1.5%
McMillan,30-34,9763,9629,134,1.4%
McMillan,45-49,10122,9989,133,1.3%
Riverina,45-49,9219,9086,133,1.4%
Fairfax,40-44,9426,9294,132,1.4%
Solomon,45-49,6844,6715,129,1.9%
Canberra,50-54,12789,12663,126,1.0%
Cook,40-44,9080,8955,125,1.4%
Whitlam,40-44,9230,9107,123,1.3%
Aston,40-44,7921,7800,121,1.5%
Bendigo,35-39,8099,7979,120,1.5%
Leichhardt,45-49,11290,11174,116,1.0%
Melbourne,50-54,7447,7332,115,1.5%
Braddon,30-34,4943,4829,114,2.3%
Lindsay,30-34,11872,11758,114,1.0%
Hughes,40-44,10112,10000,112,1.1%
Solomon,50-54,6238,6127,111,1.8%
Deakin,40-44,9219,9108,111,1.2%
Berowra,40-44,9283,9173,110,1.2%
Banks,20-24,8424,8314,110,1.3%
McPherson,40-44,9309,9201,108,1.2%
Denison,30-34,5859,5751,108,1.8%
Dickson,20-24,8690,8583,107,1.2%
Lyons,35-39,5025,4920,105,2.1%
Goldstein,40-44,9284,9180,104,1.1%
Lindsay,50-54,9001,8898,103,1.1%
Maribyrnong,25-29,9664,9561,103,1.1%
Burt,30-34,10671,10569,102,1.0%
New England,45-49,9157,9055,102,1.1%
Newcastle,40-44,9375,9274,101,1.1%
Groom,30-34,8464,8364,100,1.2%
Mallee,55-59,9680,9582,98,1.0%
Pearce,30-34,11178,11080,98,0.9%
Hotham,40-44,9146,9049,97,1.1%
Bass,25-29,5554,5458,96,1.7%
Petrie,50-54,8923,8827,96,1.1%
Riverina,35-39,8007,7911,96,1.2%
Newcastle,50-54,9267,9174,93,1.0%
Franklin,20-24,5181,5089,92,1.8%
Port Adelaide,45-49,10547,10456,91,0.9%
Lyne,45-49,8727,8637,90,1.0%
Bass,45-49,6540,6450,90,1.4%
Corangamite,20-24,8663,8574,89,1.0%
Leichhardt,55-59,10432,10344,88,0.8%
Griffith,25-29,12772,12687,85,0.7%
Fowler,25-29,9173,9089,84,0.9%
Bonner,20-24,8495,8411,84,1.0%
Fisher,30-34,6642,6558,84,1.3%
Paterson,20-24,9301,9217,84,0.9%
Barton,25-29,9094,9011,83,0.9%
Paterson,40-44,9463,9380,83,0.9%
Perth,40-44,8659,8577,82,0.9%
O'Connor,55-59,10258,10182,76,0.7%
Sturt,20-24,7775,7699,76,1.0%
Port Adelaide,50-54,10437,10363,74,0.7%
Blaxland,25-29,9521,9447,74,0.8%
Grey,55-59,10222,10148,74,0.7%
Mayo,25-29,5597,5524,73,1.3%
Sydney,50-54,8000,7927,73,0.9%
Cowan,25-29,8219,8146,73,0.9%
Lilley,30-34,10371,10298,73,0.7%
Shortland,50-54,9224,9152,72,0.8%
Makin,30-34,9139,9068,71,0.8%
Eden-Monaro,25-29,7106,7037,69,1.0%
Bendigo,45-49,9528,9460,68,0.7%
Wakefield,50-54,10371,10303,68,0.7%
Deakin,20-24,7525,7458,67,0.9%
Cowan,40-44,9041,8975,66,0.7%
Aston,50-54,8751,8686,65,0.7%
New England,30-34,7777,7713,64,0.8%
Corio,25-29,9048,8984,64,0.7%
Adelaide,50-54,9103,9041,62,0.7%
Reid,50-54,9099,9037,62,0.7%
Indi,35-39,7097,7035,62,0.9%
Reid,30-34,11047,10985,62,0.6%
Boothby,40-44,8584,8523,61,0.7%
Riverina,25-29,8581,8520,61,0.7%
Chifley,20-24,11066,11008,58,0.5%
Lalor,30-34,16392,16334,58,0.4%
Fowler,30-34,8669,8611,58,0.7%
New England,55-59,10286,10229,57,0.6%
Sturt,40-44,8284,8227,57,0.7%
Eden-Monaro,30-34,7557,7501,56,0.7%
Rankin,50-54,8480,8424,56,0.7%
Lyons,20-24,4967,4911,56,1.1%
New England,35-39,7476,7420,56,0.7%
Tangney,20-24,8009,7954,55,0.7%
Gorton,50-54,9821,9768,53,0.5%
Farrer,60-64,10058,10005,53,0.5%
Braddon,25-29,4968,4916,52,1.0%
North Sydney,30-34,10691,10639,52,0.5%
Fadden,30-34,8504,8453,51,0.6%
McMahon,40-44,9037,8988,49,0.5%
McMillan,25-29,9408,9360,48,0.5%
Corangamite,50-54,9167,9119,48,0.5%
Corio,50-54,9305,9258,47,0.5%
Casey,20-24,8657,8610,47,0.5%
Kingsford Smith,25-29,9707,9660,47,0.5%
Jagajaga,20-24,8091,8045,46,0.6%
Hunter,50-54,9651,9607,44,0.5%
Melbourne,55-59,6963,6919,44,0.6%
Moncrieff,35-39,7900,7856,44,0.6%
Moncrieff,55-59,8483,8440,43,0.5%
Parkes,70+,18512,18469,43,0.2%
Eden-Monaro,45-49,10395,10352,43,0.4%
Moore,40-44,8385,8345,40,0.5%
Wannon,30-34,6067,6027,40,0.7%
Swan,50-54,7519,7479,40,0.5%
Hindmarsh,40-44,8316,8279,37,0.5%
Calwell,40-44,9250,9214,36,0.4%
Fadden,50-54,9252,9217,35,0.4%
Flynn,55-59,9809,9775,34,0.3%
Banks,40-44,8822,8788,34,0.4%
Fisher,20-24,7031,6997,34,0.5%
Dawson,55-59,9907,9873,34,0.3%
Murray,35-39,6786,6753,33,0.5%
Bass,35-39,5271,5239,32,0.6%
Dawson,65-69,7095,7064,31,0.4%
Corangamite,40-44,9765,9735,30,0.3%
Capricornia,60-64,7916,7886,30,0.4%
Greenway,50-54,8822,8792,30,0.3%
Batman,40-44,10743,10715,28,0.3%
Fisher,25-29,6328,6301,27,0.4%
Lingiari,65-69,3201,3175,26,0.8%
New England,25-29,7919,7896,23,0.3%
Herbert,65-69,6275,6252,23,0.4%
Franklin,45-49,6838,6816,22,0.3%
Robertson,50-54,9175,9155,20,0.2%
Griffith,40-44,10499,10479,20,0.2%
Corio,35-39,8023,8004,19,0.2%
Bowman,50-54,9548,9529,19,0.2%
Kingston,30-34,9682,9664,18,0.2%
Swan,40-44,7872,7855,17,0.2%
Corio,45-49,9175,9158,17,0.2%
Braddon,35-39,4910,4894,16,0.3%
Holt,40-44,11352,11336,16,0.1%
Forde,45-49,9220,9204,16,0.2%
Mallee,65-69,8403,8387,16,0.2%
Stirling,40-44,8537,8522,15,0.2%
Cunningham,50-54,9486,9471,15,0.2%
Dobell,50-54,9291,9277,14,0.1%
New England,65-69,9061,9048,13,0.1%
Bonner,40-44,9643,9631,12,0.1%
Braddon,45-49,6301,6289,12,0.2%
Cunningham,40-44,9483,9471,12,0.1%
Murray,30-34,6786,6774,12,0.2%
Parkes,60-64,9026,9015,11,0.1%
Bowman,30-34,7521,7510,11,0.1%
Fowler,45-49,9408,9397,11,0.1%
Bruce,40-44,7527,7518,9,0.1%
Melbourne Ports,40-44,9798,9789,9,0.1%
Macarthur,50-54,8983,8974,9,0.1%
Fisher,50-54,8513,8505,8,0.1%
Watson,25-29,8878,8871,7,0.1%
Lingiari,60-64,4784,4779,5,0.1%
Kennedy,60-64,9205,9201,4,0.0%
Banks,50-54,9336,9333,3,0.0%
Groom,55-59,8824,8822,2,0.0%
Chifley,50-54,8981,8980,1,0.0%
Hinkler,55-59,9230,9231,-1,0.0%
Groom,65-69,7323,7324,-1,0.0%
Page,25-29,6924,6929,-5,-0.1%
Wannon,55-59,9527,9534,-7,-0.1%
Dunkley,50-54,8821,8828,-7,-0.1%
Werriwa,30-34,10450,10457,-7,-0.1%
Moreton,50-54,7858,7866,-8,-0.1%
Canberra,40-44,12015,12023,-8,-0.1%
Fairfax,50-54,9838,9850,-12,-0.1%
Fairfax,30-34,7713,7725,-12,-0.2%
Dunkley,45-49,9548,9560,-12,-0.1%
Bendigo,30-34,8039,8051,-12,-0.2%
Flynn,65-69,6941,6955,-14,-0.2%
Makin,35-39,8936,8950,-14,-0.2%
Hinkler,65-69,10545,10560,-15,-0.1%
Franklin,35-39,5810,5825,-15,-0.3%
Isaacs,35-39,9686,9702,-16,-0.2%
Groom,35-39,7732,7749,-17,-0.2%
Forrest,35-39,8324,8342,-18,-0.2%
Perth,50-54,8041,8059,-18,-0.2%
McMahon,45-49,9089,9108,-19,-0.2%
Melbourne,45-49,8666,8686,-20,-0.2%
Gippsland,55-59,9995,10016,-21,-0.2%
Burt,40-44,8962,8983,-21,-0.2%
Flinders,20-24,7681,7703,-22,-0.3%
Fairfax,20-24,7670,7693,-23,-0.3%
Isaacs,30-34,9194,9218,-24,-0.3%
Blair,60-64,7355,7381,-26,-0.4%
Gellibrand,30-34,11048,11075,-27,-0.2%
Fadden,45-49,9812,9839,-27,-0.3%
Indi,30-34,6933,6961,-28,-0.4%
Dunkley,25-29,7991,8021,-30,-0.4%
Calare,65-69,9009,9041,-32,-0.4%
Barker,65-69,9443,9476,-33,-0.3%
Fremantle,40-44,9254,9288,-34,-0.4%
Adelaide,25-29,10375,10409,-34,-0.3%
McMahon,30-34,9606,9641,-35,-0.4%
Denison,35-39,5483,5518,-35,-0.6%
Maranoa,60-64,9318,9354,-36,-0.4%
Moncrieff,65-69,8030,8068,-38,-0.5%
McMillan,35-39,8918,8957,-39,-0.4%
Bonner,30-34,8298,8337,-39,-0.5%
Aston,45-49,8613,8652,-39,-0.5%
Fadden,35-39,8629,8669,-40,-0.5%
McMahon,25-29,9738,9778,-40,-0.4%
Corio,30-34,8474,8516,-42,-0.5%
Bennelong,40-44,9066,9109,-43,-0.5%
Eden-Monaro,35-39,7587,7630,-43,-0.6%
Lilley,50-54,8812,8857,-45,-0.5%
Kingston,35-39,8787,8832,-45,-0.5%
Ryan,40-44,9552,9597,-45,-0.5%
Cowan,30-34,9237,9284,-47,-0.5%
Werriwa,50-54,10451,10498,-47,-0.5%
Hughes,50-54,9172,9220,-48,-0.5%
Cook,25-29,7765,7814,-49,-0.6%
Solomon,55-59,5576,5626,-50,-0.9%
Kingston,40-44,8806,8857,-51,-0.6%
Kooyong,45-49,9136,9189,-53,-0.6%
Forrest,50-54,9021,9074,-53,-0.6%
Hunter,25-29,9341,9397,-56,-0.6%
Capricornia,65-69,6674,6730,-56,-0.8%
Holt,50-54,10178,10236,-58,-0.6%
Casey,35-39,8229,8288,-59,-0.7%
Dunkley,35-39,8043,8102,-59,-0.7%
Indi,45-49,8937,8996,-59,-0.7%
Canning,30-34,7473,7532,-59,-0.8%
Gellibrand,50-54,9190,9251,-61,-0.7%
Hasluck,50-54,8511,8572,-61,-0.7%
Bendigo,25-29,8219,8281,-62,-0.8%
Gellibrand,40-44,10876,10940,-64,-0.6%
Ballarat,25-29,8906,8972,-66,-0.7%
Jagajaga,50-54,8900,8966,-66,-0.7%
Wide Bay,55-59,10581,10647,-66,-0.6%
Forrest,25-29,6864,6931,-67,-1.0%
Page,30-34,6958,7025,-67,-1.0%
Richmond,55-59,11162,11230,-68,-0.6%
Menzies,40-44,7389,7458,-69,-0.9%
Denison,55-59,6567,6636,-69,-1.1%
Page,45-49,9742,9812,-70,-0.7%
Dunkley,30-34,8071,8141,-70,-0.9%
Riverina,55-59,9987,10058,-71,-0.7%
Grey,65-69,8861,8932,-71,-0.8%
Lyne,35-39,5996,6068,-72,-1.2%
Mallee,20-24,7139,7213,-74,-1.0%
Tangney,40-44,7177,7251,-74,-1.0%
Flynn,60-64,8035,8110,-75,-0.9%
Macquarie,50-54,9419,9495,-76,-0.8%
Reid,40-44,9610,9687,-77,-0.8%
Dickson,50-54,9102,9180,-78,-0.9%
Page,35-39,7591,7669,-78,-1.0%
Hume,50-54,9577,9656,-79,-0.8%
Hasluck,35-39,7805,7884,-79,-1.0%
Blaxland,50-54,8731,8811,-80,-0.9%
Braddon,20-24,5308,5389,-81,-1.5%
Rankin,35-39,9999,10081,-82,-0.8%
McMahon,50-54,9137,9219,-82,-0.9%
Riverina,65-69,8888,8970,-82,-0.9%
Casey,30-34,8767,8851,-84,-1.0%
Melbourne Ports,45-49,9158,9242,-84,-0.9%
Mackellar,40-44,9984,10069,-85,-0.9%
Melbourne Ports,55-59,7630,7715,-85,-1.1%
Stirling,50-54,7638,7724,-86,-1.1%
Canning,25-29,7342,7429,-87,-1.2%
Riverina,60-64,9183,9271,-88,-1.0%
Hasluck,45-49,8903,8991,-88,-1.0%
Scullin,40-44,9877,9966,-89,-0.9%
Solomon,60-64,4492,4584,-92,-2.0%
Calwell,45-49,10567,10659,-92,-0.9%
Denison,45-49,6306,6398,-92,-1.5%
Kingston,50-54,8652,8745,-93,-1.1%
Brisbane,45-49,10053,10146,-93,-0.9%
Leichhardt,65-69,7417,7511,-94,-1.3%
Ballarat,35-39,8615,8711,-96,-1.1%
Hunter,20-24,9400,9497,-97,-1.0%
Greenway,30-34,11167,11264,-97,-0.9%
Casey,50-54,9071,9171,-100,-1.1%
Richmond,20-24,6264,6364,-100,-1.6%
Macarthur,40-44,9697,9797,-100,-1.0%
Adelaide,40-44,8810,8911,-101,-1.1%
Sydney,65-69,5015,5116,-101,-2.0%
Fairfax,35-39,7964,8065,-101,-1.3%
Fadden,25-29,8733,8835,-102,-1.2%
Cook,30-34,7683,7785,-102,-1.3%
Forrest,45-49,9525,9629,-104,-1.1%
Hindmarsh,25-29,8718,8823,-105,-1.2%
Adelaide,45-49,9223,9329,-106,-1.1%
Flinders,50-54,9572,9678,-106,-1.1%
Kingsford Smith,50-54,8992,9099,-107,-1.2%
Mallee,60-64,8925,9033,-108,-1.2%
Lindsay,35-39,10788,10896,-108,-1.0%
Durack,70+,10399,10507,-108,-1.0%
Barker,60-64,9702,9811,-109,-1.1%
McPherson,50-54,8528,8638,-110,-1.3%
Lindsay,45-49,9712,9822,-110,-1.1%
Berowra,50-54,10037,10148,-111,-1.1%
McMillan,20-24,9068,9180,-112,-1.2%
Burt,50-54,8248,8361,-113,-1.4%
Jagajaga,40-44,9332,9446,-114,-1.2%
Dickson,35-39,9071,9185,-114,-1.3%
Cook,35-39,7893,8010,-117,-1.5%
Murray,65-69,8910,9027,-117,-1.3%
Deakin,35-39,8440,8557,-117,-1.4%
Bass,65-69,5628,5746,-118,-2.1%
Cook,20-24,7569,7688,-119,-1.6%
Swan,45-49,7854,7973,-119,-1.5%
McEwen,35-39,14081,14201,-120,-0.9%
Page,55-59,11982,12104,-122,-1.0%
Cowper,30-34,7007,7129,-122,-1.7%
Herbert,55-59,8682,8805,-123,-1.4%
Gilmore,35-39,6591,6714,-123,-1.9%
Braddon,65-69,6062,6186,-124,-2.0%
Canning,50-54,8507,8631,-124,-1.5%
Swan,55-59,7412,7536,-124,-1.7%
Aston,30-34,7394,7520,-126,-1.7%
Richmond,35-39,7377,7503,-126,-1.7%
Bowman,20-24,7976,8103,-127,-1.6%
Rankin,45-49,9019,9146,-127,-1.4%
Fremantle,50-54,8609,8737,-128,-1.5%
Maribyrnong,30-34,9603,9733,-130,-1.3%
Holt,30-34,13031,13161,-130,-1.0%
Sydney,30-34,17279,17409,-130,-0.8%
Blair,55-59,8486,8618,-132,-1.6%
Indi,65-69,9186,9320,-134,-1.5%
Parramatta,30-34,11447,11582,-135,-1.2%
Cowper,25-29,7205,7340,-135,-1.9%
Kooyong,50-54,9074,9210,-136,-1.5%
Bowman,35-39,7438,7574,-136,-1.8%
Calare,55-59,10252,10389,-137,-1.3%
Casey,25-29,8637,8774,-137,-1.6%
Boothby,50-54,9041,9178,-137,-1.5%
Bennelong,50-54,9423,9560,-137,-1.5%
Dawson,60-64,8360,8498,-138,-1.6%
Greenway,20-24,8824,8962,-138,-1.6%
Bonner,45-49,9569,9709,-140,-1.5%
Paterson,25-29,9417,9557,-140,-1.5%
Wannon,60-64,9240,9381,-141,-1.5%
Mayo,45-49,9381,9523,-142,-1.5%
Lingiari,70+,3725,3868,-143,-3.8%
Petrie,45-49,9377,9522,-145,-1.5%
Murray,55-59,9668,9813,-145,-1.5%
Mitchell,40-44,10796,10942,-146,-1.3%
Cowper,55-59,11376,11524,-148,-1.3%
Blair,65-69,6497,6645,-148,-2.3%
Deakin,25-29,7107,7257,-150,-2.1%
Makin,45-49,9429,9581,-152,-1.6%
Hinkler,60-64,9518,9670,-152,-1.6%
Bruce,45-49,7978,8131,-153,-1.9%
Bradfield,40-44,9055,9209,-154,-1.7%
Hindmarsh,50-54,9118,9274,-156,-1.7%
Franklin,55-59,7308,7464,-156,-2.1%
Fowler,35-39,8166,8322,-156,-1.9%
Batman,50-54,8751,8908,-157,-1.8%
Deakin,50-54,8188,8346,-158,-1.9%
Wannon,25-29,6112,6272,-160,-2.6%
Cowper,65-69,11180,11340,-160,-1.4%
Hindmarsh,45-49,9128,9288,-160,-1.8%
Stirling,45-49,8236,8397,-161,-2.0%
Scullin,25-29,9627,9789,-162,-1.7%
Bendigo,55-59,9836,9999,-163,-1.7%
Wannon,65-69,8750,8913,-163,-1.9%
Chifley,40-44,9440,9606,-166,-1.8%
Lyne,25-29,5498,5664,-166,-3.0%
Fisher,35-39,7027,7195,-168,-2.4%
Bruce,50-54,7776,7944,-168,-2.2%
Forde,65-69,6798,6966,-168,-2.5%
Grey,60-64,9462,9632,-170,-1.8%
Deakin,30-34,7873,8043,-170,-2.2%
Ballarat,30-34,8491,8664,-173,-2.0%
Melbourne Ports,65-69,6116,6289,-173,-2.8%
Lyons,55-59,8051,8225,-174,-2.2%
Brand,45-49,9346,9520,-174,-1.9%
Greenway,40-44,11564,11738,-174,-1.5%
New England,60-64,9509,9684,-175,-1.8%
Reid,45-49,9239,9414,-175,-1.9%
Blaxland,40-44,8637,8813,-176,-2.0%
Petrie,35-39,9272,9449,-177,-1.9%
Sydney,55-59,7124,7301,-177,-2.5%
Page,20-24,7407,7584,-177,-2.4%
Lalor,40-44,13661,13839,-178,-1.3%
Braddon,55-59,6855,7034,-179,-2.6%
Sturt,50-54,8728,8907,-179,-2.1%
Calare,60-64,9137,9316,-179,-2.0%
Makin,50-54,8980,9160,-180,-2.0%
Werriwa,45-49,10540,10720,-180,-1.7%
Lilley,45-49,9626,9807,-181,-1.9%
Gorton,45-49,11725,11906,-181,-1.5%
O'Connor,65-69,8293,8475,-182,-2.2%
Canning,45-49,8398,8581,-183,-2.2%
Ballarat,45-49,9931,10114,-183,-1.8%
Warringah,25-29,7036,7219,-183,-2.6%
Moreton,40-44,8454,8638,-184,-2.2%
Macarthur,30-34,11060,11246,-186,-1.7%
Grayndler,50-54,8681,8867,-186,-2.1%
Adelaide,55-59,9006,9192,-186,-2.1%
Fadden,65-69,8053,8239,-186,-2.3%
Solomon,65-69,3399,3586,-187,-5.5%
Gilmore,30-34,6569,6757,-188,-2.9%
Hume,35-39,8753,8942,-189,-2.2%
Hughes,30-34,8323,8512,-189,-2.3%
Whitlam,50-54,9435,9624,-189,-2.0%
McEwen,50-54,11954,12143,-189,-1.6%
Longman,60-64,8578,8768,-190,-2.2%
Moreton,25-29,8613,8805,-192,-2.2%
Wright,65-69,7822,8015,-193,-2.5%
Perth,30-34,10803,10998,-195,-1.8%
Indi,25-29,6639,6834,-195,-2.9%
McEwen,45-49,13516,13711,-195,-1.4%
Kingsford Smith,40-44,10292,10488,-196,-1.9%
Deakin,65-69,6376,6573,-197,-3.1%
Melbourne,65-69,5077,5274,-197,-3.9%
Griffith,50-54,8402,8599,-197,-2.4%
Sturt,45-49,9180,9378,-198,-2.2%
Forrest,20-24,6400,6598,-198,-3.1%
Shortland,65-69,8481,8679,-198,-2.3%
Newcastle,25-29,11254,11452,-198,-1.8%
Barker,55-59,10138,10338,-200,-2.0%
Perth,45-49,8480,8680,-200,-2.4%
Cowper,45-49,9278,9478,-200,-2.2%
Shortland,30-34,7906,8106,-200,-2.5%
Gippsland,65-69,9655,9856,-201,-2.1%
Parramatta,40-44,9528,9732,-204,-2.1%
Canning,35-39,7001,7205,-204,-2.9%
Leichhardt,60-64,8900,9105,-205,-2.3%
Isaacs,50-54,9285,9490,-205,-2.2%
Lyne,30-34,5541,5748,-207,-3.7%
Dawson,70+,13653,13860,-207,-1.5%
Wide Bay,65-69,10771,10978,-207,-1.9%
Hume,20-24,8798,9006,-208,-2.4%
Bowman,45-49,9192,9401,-209,-2.3%
Maribyrnong,50-54,9314,9524,-210,-2.2%
Cowper,35-39,7041,7251,-210,-3.0%
Bonner,50-54,8969,9181,-212,-2.4%
Fairfax,25-29,7115,7327,-212,-3.0%
Longman,55-59,8807,9019,-212,-2.4%
Scullin,50-54,9859,10072,-213,-2.2%
Braddon,60-64,6314,6527,-213,-3.4%
Flinders,35-39,7448,7663,-215,-2.9%
Dobell,30-34,8442,8658,-216,-2.6%
Hotham,30-34,7449,7665,-216,-2.9%
Brisbane,65-69,4981,5199,-218,-4.4%
Adelaide,30-34,9888,10107,-219,-2.2%
O'Connor,60-64,9085,9304,-219,-2.4%
Hunter,35-39,8697,8917,-220,-2.5%
Capricornia,70+,13228,13450,-222,-1.7%
Wright,60-64,8299,8521,-222,-2.7%
McPherson,30-34,8090,8313,-223,-2.8%
Swan,70+,13419,13642,-223,-1.7%
Herbert,60-64,7108,7332,-224,-3.2%
Dickson,65-69,6654,6879,-225,-3.4%
Maribyrnong,45-49,10213,10439,-226,-2.2%
Indi,20-24,6994,7222,-228,-3.3%
Watson,50-54,9246,9475,-229,-2.5%
Murray,25-29,6906,7135,-229,-3.3%
Bonner,35-39,8575,8805,-230,-2.7%
Barton,40-44,9708,9939,-231,-2.4%
Hunter,30-34,9327,9558,-231,-2.5%
Shortland,45-49,9312,9544,-232,-2.5%
Melbourne,40-44,9477,9709,-232,-2.5%
Groom,60-64,7728,7961,-233,-3.0%
Burt,45-49,8807,9040,-233,-2.6%
Dickson,25-29,7847,8080,-233,-3.0%
Brand,50-54,8537,8770,-233,-2.7%
Moncrieff,60-64,7806,8040,-234,-3.0%
Higgins,50-54,8148,8382,-234,-2.9%
Brand,35-39,8951,9189,-238,-2.7%
Bass,60-64,5928,6166,-238,-4.0%
Flinders,30-34,7202,7440,-238,-3.3%
Page,60-64,11847,12086,-239,-2.0%
Lindsay,55-59,8702,8941,-239,-2.7%
Paterson,30-34,9148,9388,-240,-2.6%
Menzies,50-54,8913,9153,-240,-2.7%
Indi,55-59,10123,10363,-240,-2.4%
Menzies,20-24,7890,8130,-240,-3.0%
Page,65-69,10718,10960,-242,-2.3%
Sturt,65-69,7266,7509,-243,-3.3%
Reid,35-39,9932,10175,-243,-2.5%
Hotham,50-54,8452,8695,-243,-2.9%
Swan,30-34,9884,10128,-244,-2.5%
Curtin,45-49,8657,8902,-245,-2.8%
McMahon,35-39,9403,9651,-248,-2.6%
Watson,45-49,9179,9427,-248,-2.7%
Murray,60-64,9299,9547,-248,-2.7%
Eden-Monaro,55-59,10812,11061,-249,-2.3%
Paterson,65-69,8898,9148,-250,-2.8%
Casey,45-49,9410,9660,-250,-2.7%
Port Adelaide,35-39,9422,9672,-250,-2.7%
Watson,40-44,9050,9301,-251,-2.8%
Boothby,45-49,8954,9205,-251,-2.8%
Hughes,35-39,8973,9225,-252,-2.8%
Lyne,65-69,11926,12179,-253,-2.1%
Boothby,35-39,7580,7833,-253,-3.3%
Forde,55-59,7940,8193,-253,-3.2%
Eden-Monaro,65-69,9000,9254,-254,-2.8%
Cook,50-54,8729,8986,-257,-2.9%
McPherson,35-39,8324,8581,-257,-3.1%
Chisholm,50-54,8082,8341,-259,-3.2%
North Sydney,50-54,8567,8826,-259,-3.0%
Banks,30-34,8005,8264,-259,-3.2%
Shortland,25-29,7369,7629,-260,-3.5%
Brisbane,55-59,7486,7746,-260,-3.5%
Oxley,65-69,5301,5561,-260,-4.9%
Dobell,65-69,8140,8401,-261,-3.2%
Blaxland,45-49,8689,8950,-261,-3.0%
Bennelong,25-29,8016,8277,-261,-3.3%
Forrest,55-59,9100,9364,-264,-2.9%
North Sydney,40-44,10198,10462,-264,-2.6%
Hotham,25-29,6659,6923,-264,-4.0%
Robertson,45-49,8828,9092,-264,-3.0%
Fisher,45-49,8591,8856,-265,-3.1%
Hume,30-34,8954,9219,-265,-3.0%
Aston,35-39,7459,7725,-266,-3.6%
McMillan,55-59,10007,10273,-266,-2.7%
Wills,50-54,8629,8895,-266,-3.1%
Hume,25-29,8715,8982,-267,-3.1%
Calwell,50-54,10567,10836,-269,-2.5%
McPherson,65-69,7547,7816,-269,-3.6%
Bradfield,50-54,9835,10107,-272,-2.8%
Lalor,50-54,10637,10911,-274,-2.6%
Kingston,45-49,8837,9112,-275,-3.1%
Hunter,45-49,9702,9977,-275,-2.8%
Goldstein,45-49,10888,11165,-277,-2.5%
Richmond,65-69,10265,10542,-277,-2.7%
Lilley,65-69,6083,6360,-277,-4.6%
Fremantle,30-34,9442,9719,-277,-2.9%
Dobell,35-39,8300,8579,-279,-3.4%
Bowman,25-29,6872,7151,-279,-4.1%
Franklin,65-69,6380,6660,-280,-4.4%
Batman,65-69,5321,5601,-280,-5.3%
Bass,55-59,6521,6802,-281,-4.3%
Fairfax,45-49,9891,10172,-281,-2.8%
Watson,30-34,9544,9827,-283,-3.0%
Blaxland,30-34,9387,9671,-284,-3.0%
Curtin,25-29,7977,8262,-285,-3.6%
Jagajaga,45-49,9427,9712,-285,-3.0%
Holt,45-49,10867,11152,-285,-2.6%
Swan,35-39,8584,8870,-286,-3.3%
Sturt,25-29,7086,7372,-286,-4.0%
McPherson,45-49,9123,9410,-287,-3.1%
Petrie,65-69,7738,8025,-287,-3.7%
Mackellar,50-54,9656,9944,-288,-3.0%
Berowra,35-39,7055,7343,-288,-4.1%
Lyons,60-64,7644,7933,-289,-3.8%
Brisbane,60-64,6070,6360,-290,-4.8%
Pearce,35-39,9919,10209,-290,-2.9%
Grayndler,40-44,11174,11465,-291,-2.6%
Gilmore,45-49,8362,8654,-292,-3.5%
Scullin,30-34,10127,10419,-292,-2.9%
Lyne,55-59,10689,10982,-293,-2.7%
La Trobe,35-39,9360,9655,-295,-3.2%
Wentworth,65-69,6067,6362,-295,-4.9%
Hughes,25-29,7971,8267,-296,-3.7%
Richmond,60-64,10765,11063,-298,-2.8%
Fenner,30-34,15941,16239,-298,-1.9%
Macquarie,45-49,9763,10062,-299,-3.1%
Flinders,45-49,9793,10092,-299,-3.1%
Richmond,45-49,9420,9720,-300,-3.2%
Chisholm,65-69,5612,5914,-302,-5.4%
McPherson,25-29,7817,8120,-303,-3.9%
Kooyong,35-39,6605,6908,-303,-4.6%
Pearce,65-69,6212,6515,-303,-4.9%
Curtin,35-39,6890,7195,-305,-4.4%
Moreton,45-49,8310,8616,-306,-3.7%
Hotham,65-69,6271,6578,-307,-4.9%
Cunningham,65-69,7032,7339,-307,-4.4%
Isaacs,45-49,10334,10641,-307,-3.0%
La Trobe,20-24,9698,10006,-308,-3.2%
Tangney,45-49,7922,8230,-308,-3.9%
Hindmarsh,30-34,8390,8699,-309,-3.7%
Chisholm,45-49,8890,9200,-310,-3.5%
Hume,45-49,9923,10234,-311,-3.1%
Paterson,45-49,9387,9699,-312,-3.3%
Paterson,35-39,8724,9036,-312,-3.6%
Gilmore,25-29,6468,6781,-313,-4.8%
Stirling,30-34,9661,9974,-313,-3.2%
Hindmarsh,35-39,7955,8270,-315,-4.0%
Melbourne,60-64,5882,6198,-316,-5.4%
Hunter,55-59,9857,10173,-316,-3.2%
Shortland,35-39,7594,7911,-317,-4.2%
Whitlam,30-34,8172,8490,-318,-3.9%
Adelaide,35-39,8783,9101,-318,-3.6%
Corangamite,30-34,8403,8722,-319,-3.8%
Corangamite,35-39,8636,8956,-320,-3.7%
Melbourne,30-34,17394,17714,-320,-1.8%
Hotham,45-49,9453,9774,-321,-3.4%
Hunter,65-69,8492,8813,-321,-3.8%
Denison,60-64,5774,6096,-322,-5.6%
Rankin,55-59,8203,8526,-323,-3.9%
Fowler,55-59,9678,10002,-324,-3.3%
Cunningham,30-34,8415,8739,-324,-3.8%
Menzies,45-49,8880,9204,-324,-3.7%
La Trobe,45-49,11296,11621,-325,-2.9%
Bennelong,30-34,8610,8935,-325,-3.8%
Sturt,30-34,7127,7452,-325,-4.6%
Macquarie,35-39,7642,7968,-326,-4.3%
Deakin,45-49,9005,9331,-326,-3.6%
Chifley,45-49,9275,9601,-326,-3.5%
Parramatta,45-49,8572,8899,-327,-3.8%
Corangamite,25-29,7643,7970,-327,-4.3%
Lyons,65-69,7497,7824,-327,-4.4%
La Trobe,50-54,10094,10422,-328,-3.2%
Batman,55-59,7697,8025,-328,-4.3%
Bendigo,65-69,8754,9082,-328,-3.7%
Swan,65-69,5834,6163,-329,-5.6%
Bonner,25-29,7205,7535,-330,-4.6%
Brisbane,30-34,12721,13052,-331,-2.6%
Curtin,50-54,8155,8486,-331,-4.1%
Lilley,35-39,9395,9727,-332,-3.5%
Newcastle,55-59,9128,9460,-332,-3.6%
Newcastle,65-69,6694,7028,-334,-5.0%
Dobell,45-49,9441,9775,-334,-3.5%
Higgins,45-49,9024,9358,-334,-3.7%
Chifley,55-59,8263,8599,-336,-4.1%
Warringah,30-34,8091,8429,-338,-4.2%
Cunningham,45-49,9190,9530,-340,-3.7%
Mayo,55-59,9957,10297,-340,-3.4%
Calwell,25-29,9872,10213,-341,-3.5%
Macquarie,30-34,7286,7627,-341,-4.7%
Gellibrand,45-49,10172,10514,-342,-3.4%
Oxley,55-59,7692,8035,-343,-4.5%
Parramatta,55-59,7749,8095,-346,-4.5%
Mitchell,30-34,7379,7727,-348,-4.7%
Fremantle,45-49,9368,9717,-349,-3.7%
Fisher,65-69,8413,8763,-350,-4.2%
Perth,55-59,7593,7945,-352,-4.6%
Mitchell,50-54,9064,9416,-352,-3.9%
Hotham,35-39,8233,8585,-352,-4.3%
Shortland,20-24,8259,8612,-353,-4.3%
Tangney,50-54,7979,8334,-355,-4.4%
Gellibrand,35-39,11094,11449,-355,-3.2%
Fremantle,35-39,9145,9500,-355,-3.9%
Gellibrand,65-69,5753,6110,-357,-6.2%
Scullin,45-49,10058,10415,-357,-3.5%
Wills,40-44,10639,10996,-357,-3.4%
Moreton,65-69,5680,6038,-358,-6.3%
Aston,25-29,7610,7968,-358,-4.7%
Melbourne Ports,60-64,6497,6855,-358,-5.5%
McPherson,55-59,8509,8868,-359,-4.2%
Denison,65-69,5153,5515,-362,-7.0%
Tangney,35-39,6009,6372,-363,-6.0%
Sturt,35-39,7339,7704,-365,-5.0%
Boothby,55-59,9197,9562,-365,-4.0%
Rankin,65-69,6397,6763,-366,-5.7%
Macarthur,45-49,8736,9102,-366,-4.2%
Moore,50-54,9567,9934,-367,-3.8%
Parramatta,65-69,5202,5569,-367,-7.1%
Greenway,35-39,12601,12968,-367,-2.9%
Watson,35-39,9444,9811,-367,-3.9%
Cowan,35-39,8921,9289,-368,-4.1%
Berowra,45-49,9895,10264,-369,-3.7%
Dunkley,65-69,7565,7934,-369,-4.9%
Jagajaga,35-39,8287,8657,-370,-4.5%
Ballarat,65-69,8429,8801,-372,-4.4%
Bruce,55-59,7575,7948,-373,-4.9%
Wright,55-59,9407,9781,-374,-4.0%
Forde,60-64,6966,7341,-375,-5.4%
Bendigo,60-64,9315,9690,-375,-4.0%
Melbourne Ports,35-39,10977,11353,-376,-3.4%
Cunningham,35-39,8325,8702,-377,-4.5%
Forrest,65-69,7928,8305,-377,-4.8%
Hasluck,60-64,7151,7529,-378,-5.3%
Lalor,45-49,12193,12572,-379,-3.1%
Griffith,55-59,7326,7705,-379,-5.2%
Werriwa,25-29,9877,10256,-379,-3.8%
Brand,65-69,5365,5744,-379,-7.1%
Dobell,20-24,9107,9487,-380,-4.2%
Goldstein,50-54,9859,10239,-380,-3.9%
Wakefield,65-69,6993,7373,-380,-5.4%
Batman,30-34,11321,11702,-381,-3.4%
Dickson,45-49,10213,10595,-382,-3.7%
Bruce,35-39,6772,7154,-382,-5.6%
Chisholm,25-29,6961,7343,-382,-5.5%
Sydney,60-64,5778,6161,-383,-6.6%
La Trobe,30-34,8280,8663,-383,-4.6%
Robertson,35-39,7202,7587,-385,-5.3%
Jagajaga,55-59,8784,9169,-385,-4.4%
Corangamite,45-49,9541,9926,-385,-4.0%
Chifley,30-34,10279,10664,-385,-3.7%
Wentworth,50-54,7515,7900,-385,-5.1%
Hughes,65-69,6423,6809,-386,-6.0%
Fadden,55-59,8624,9011,-387,-4.5%
Goldstein,35-39,6930,7318,-388,-5.6%
Lilley,55-59,8068,8457,-389,-4.8%
Bennelong,45-49,9097,9486,-389,-4.3%
Lindsay,65-69,6774,7163,-389,-5.7%
Wills,65-69,4957,5346,-389,-7.9%
Makin,65-69,7580,7971,-391,-5.2%
Kingsford Smith,65-69,5998,6389,-391,-6.5%
Boothby,30-34,7121,7514,-393,-5.5%
Moreton,55-59,7286,7680,-394,-5.4%
McEwen,65-69,7777,8171,-394,-5.1%
Bonner,65-69,6160,6554,-394,-6.4%
Newcastle,45-49,9200,9595,-395,-4.3%
Lilley,60-64,6961,7357,-396,-5.7%
Hasluck,65-69,6837,7233,-396,-5.8%
Newcastle,30-34,9945,10341,-396,-4.0%
Whitlam,35-39,8099,8496,-397,-4.9%
Grayndler,30-34,11702,12100,-398,-3.4%
North Sydney,65-69,6574,6972,-398,-6.1%
Perth,65-69,5900,6298,-398,-6.7%
Menzies,35-39,6175,6574,-399,-6.5%
Lalor,65-69,5843,6243,-400,-6.8%
Moore,20-24,8526,8926,-400,-4.7%
Robertson,30-34,6961,7362,-401,-5.8%
Macquarie,20-24,8095,8497,-402,-5.0%
Jagajaga,65-69,6877,7280,-403,-5.9%
Higgins,65-69,6049,6452,-403,-6.7%
Whitlam,45-49,9265,9669,-404,-4.4%
Gilmore,20-24,6906,7311,-405,-5.9%
Grayndler,60-64,6183,6588,-405,-6.6%
Cowan,45-49,9057,9463,-406,-4.5%
Paterson,55-59,9457,9864,-407,-4.3%
Ryan,50-54,8478,8885,-407,-4.8%
Griffith,65-69,4677,5087,-410,-8.8%
Canberra,30-34,12504,12914,-410,-3.3%
Ballarat,60-64,8891,9302,-411,-4.6%
Cowan,50-54,8312,8724,-412,-5.0%
Petrie,60-64,7588,8001,-413,-5.4%
Blaxland,65-69,5796,6209,-413,-7.1%
Chifley,25-29,9881,10294,-413,-4.2%
Oxley,60-64,6222,6635,-413,-6.6%
Adelaide,65-69,7238,7652,-414,-5.7%
Melbourne,70+,9516,9932,-416,-4.4%
Gilmore,55-59,11000,11416,-416,-3.8%
Cunningham,25-29,8934,9350,-416,-4.7%
Warringah,20-24,6286,6703,-417,-6.6%
Moreton,35-39,8573,8990,-417,-4.9%
Banks,45-49,8909,9327,-418,-4.7%
Cowper,20-24,7270,7689,-419,-5.8%
Pearce,45-49,10769,11188,-419,-3.9%
Bruce,65-69,6666,7086,-420,-6.3%
Mitchell,35-39,9387,9808,-421,-4.5%
Ryan,30-34,7562,7984,-422,-5.6%
Cowan,65-69,5627,6049,-422,-7.5%
Farrer,70+,21437,21860,-423,-2.0%
Canning,65-69,8300,8723,-423,-5.1%
Fisher,55-59,8501,8925,-424,-5.0%
Gippsland,60-64,9705,10129,-424,-4.4%
Macquarie,25-29,7358,7782,-424,-5.8%
Batman,45-49,10463,10888,-425,-4.1%
Kooyong,65-69,6244,6669,-425,-6.8%
Mitchell,20-24,8481,8907,-426,-5.0%
Ryan,65-69,6263,6691,-428,-6.8%
Robertson,25-29,7091,7520,-429,-6.0%
Bruce,30-34,6734,7163,-429,-6.4%
Stirling,55-59,7308,7738,-430,-5.9%
Whitlam,25-29,7932,8363,-431,-5.4%
Moore,45-49,9392,9824,-432,-4.6%
Stirling,65-69,6178,6611,-433,-7.0%
Hindmarsh,65-69,7770,8203,-433,-5.6%
Warringah,65-69,6024,6458,-434,-7.2%
Wills,45-49,9884,10319,-435,-4.4%
Longman,65-69,8624,9060,-436,-5.1%
Wide Bay,60-64,10397,10837,-440,-4.2%
Brisbane,35-39,10368,10808,-440,-4.2%
Banks,35-39,8143,8583,-440,-5.4%
Cowan,55-59,7526,7966,-440,-5.9%
Corio,55-59,9008,9450,-442,-4.9%
Perth,70+,12665,13109,-444,-3.5%
Swan,60-64,6628,7072,-444,-6.7%
Sydney,40-44,10366,10811,-445,-4.3%
Kingsford Smith,30-34,10123,10568,-445,-4.4%
Banks,25-29,7609,8054,-445,-5.9%
Griffith,30-34,12208,12653,-445,-3.6%
Fenner,50-54,10244,10690,-446,-4.4%
Maribyrnong,35-39,8941,9387,-446,-5.0%
Kingsford Smith,45-49,9730,10178,-448,-4.6%
Shortland,55-59,9378,9827,-449,-4.8%
Berowra,65-69,6915,7364,-449,-6.5%
Canberra,45-49,12599,13050,-451,-3.6%
Higgins,30-34,10548,10999,-451,-4.3%
Robertson,65-69,8230,8682,-452,-5.5%
Burt,35-39,9719,10172,-453,-4.7%
Chisholm,35-39,6992,7445,-453,-6.5%
Barton,50-54,8922,9375,-453,-5.1%
Werriwa,35-39,10253,10706,-453,-4.4%
Burt,65-69,5769,6225,-456,-7.9%
Paterson,60-64,8889,9345,-456,-5.1%
Pearce,50-54,9468,9925,-457,-4.8%
Cook,65-69,6763,7220,-457,-6.8%
Reid,55-59,8279,8736,-457,-5.5%
Deakin,55-59,7316,7774,-458,-6.3%
North Sydney,45-49,9417,9875,-458,-4.9%
Ballarat,55-59,9525,9984,-459,-4.8%
Maranoa,70+,17981,18440,-459,-2.6%
Mayo,65-69,9955,10416,-461,-4.6%
Solomon,70+,4412,4873,-461,-10.4%
Stirling,35-39,8490,8951,-461,-5.4%
Greenway,65-69,5364,5825,-461,-8.6%
Jagajaga,25-29,7344,7805,-461,-6.3%
Wills,55-59,7385,7847,-462,-6.3%
Gorton,55-59,8692,9155,-463,-5.3%
Moore,35-39,6924,7389,-465,-6.7%
Perth,60-64,6824,7290,-466,-6.8%
Bruce,25-29,6790,7256,-466,-6.9%
Indi,60-64,9643,10109,-466,-4.8%
Pearce,60-64,6681,7148,-467,-7.0%
Leichhardt,70+,11738,12205,-467,-4.0%
Dobell,55-59,9137,9604,-467,-5.1%
Whitlam,20-24,8655,9125,-470,-5.4%
Mitchell,65-69,6433,6904,-471,-7.3%
Ryan,35-39,8131,8602,-471,-5.8%
Petrie,55-59,8099,8570,-471,-5.8%
Rankin,60-64,7078,7549,-471,-6.7%
Higgins,60-64,6428,6900,-472,-7.3%
Blaxland,55-59,8364,8837,-473,-5.7%
Gellibrand,55-59,8351,8826,-475,-5.7%
Corio,65-69,8078,8554,-476,-5.9%
Flinders,25-29,7056,7533,-477,-6.8%
Tangney,55-59,8006,8484,-478,-6.0%
Chisholm,30-34,6832,7310,-478,-7.0%
Reid,65-69,5941,6420,-479,-8.1%
Wakefield,55-59,9663,10143,-480,-5.0%
Bonner,60-64,6757,7237,-480,-7.1%
Deakin,60-64,6480,6960,-480,-7.4%
Curtin,55-59,7708,8189,-481,-6.2%
Kingsford Smith,60-64,6651,7133,-482,-7.2%
Griffith,60-64,5801,6284,-483,-8.3%
Parramatta,35-39,10671,11155,-484,-4.5%
Hughes,45-49,9604,10089,-485,-5.0%
Brisbane,70+,9398,9884,-486,-5.2%
McMahon,55-59,8744,9231,-487,-5.6%
Scullin,65-69,6713,7201,-488,-7.3%
Port Adelaide,65-69,6837,7326,-489,-7.1%
Hotham,55-59,7882,8371,-489,-6.2%
Franklin,60-64,6652,7143,-491,-7.4%
Macquarie,65-69,7843,8336,-493,-6.3%
Hume,60-64,8089,8582,-493,-6.1%
Watson,55-59,8198,8692,-494,-6.0%
Chifley,65-69,5923,6417,-494,-8.3%
Robertson,55-59,9242,9738,-496,-5.4%
Corangamite,55-59,9311,9807,-496,-5.3%
Casey,65-69,7081,7578,-497,-7.0%
McMillan,65-69,9324,9822,-498,-5.3%
Banks,65-69,6340,6838,-498,-7.9%
Dobell,60-64,8381,8880,-499,-6.0%
Lyne,60-64,11012,11512,-500,-4.5%
Bradfield,35-39,7544,8044,-500,-6.6%
Berowra,30-34,5381,5882,-501,-9.3%
Port Adelaide,55-59,9976,10478,-502,-5.0%
Bruce,60-64,6824,7326,-502,-7.4%
North Sydney,55-59,7818,8320,-502,-6.4%
Burt,60-64,6682,7185,-503,-7.5%
Grayndler,65-69,5267,5772,-505,-9.6%
Greenway,45-49,9760,10266,-506,-5.2%
Mackellar,35-39,7854,8361,-507,-6.4%
Hume,65-69,7495,8002,-507,-6.8%
Higgins,55-59,7418,7926,-508,-6.9%
Hindmarsh,60-64,8149,8660,-511,-6.3%
Macarthur,55-59,8773,9285,-512,-5.8%
Fenner,65-69,7171,7683,-512,-7.1%
Cook,45-49,9171,9684,-513,-5.6%
Goldstein,65-69,7113,7627,-514,-7.2%
Kooyong,25-29,8154,8668,-514,-6.3%
Chisholm,55-59,7308,7822,-514,-7.0%
Dickson,55-59,8283,8798,-515,-6.2%
Goldstein,20-24,7368,7883,-515,-7.0%
Lyne,20-24,5903,6418,-515,-8.7%
Bennelong,55-59,8446,8962,-516,-6.1%
Mackellar,65-69,7239,7755,-516,-7.1%
Hindmarsh,55-59,8982,9499,-517,-5.8%
Kennedy,70+,16288,16805,-517,-3.2%
Dickson,60-64,7003,7521,-518,-7.4%
Ryan,60-64,6697,7219,-522,-7.8%
Moreton,60-64,6199,6721,-522,-8.4%
Warringah,50-54,8904,9426,-522,-5.9%
Hotham,60-64,6786,7308,-522,-7.7%
Flynn,70+,11800,12322,-522,-4.4%
Maribyrnong,65-69,6789,7312,-523,-7.7%
Lindsay,60-64,7454,7977,-523,-7.0%
McPherson,60-64,7662,8185,-523,-6.8%
Calwell,65-69,6345,6869,-524,-8.3%
Bradfield,65-69,6366,6890,-524,-8.2%
Canning,60-64,7941,8466,-525,-6.6%
McMillan,60-64,9436,9962,-526,-5.6%
Bradfield,45-49,10143,10669,-526,-5.2%
Cook,55-59,8369,8896,-527,-6.3%
Parramatta,70+,11835,12362,-527,-4.5%
Macquarie,60-64,8519,9047,-528,-6.2%
Blaxland,35-39,8634,9163,-529,-6.1%
Gilmore,65-69,11813,12342,-529,-4.5%
Kingston,55-59,8585,9114,-529,-6.2%
McMahon,65-69,6384,6913,-529,-8.3%
Bonner,55-59,7961,8492,-531,-6.7%
Brand,60-64,6061,6592,-531,-8.8%
Berowra,20-24,8835,9366,-531,-6.0%
Newcastle,35-39,8931,9464,-533,-6.0%
Griffith,45-49,9774,10307,-533,-5.4%
Casey,55-59,8699,9232,-533,-6.1%
Hasluck,55-59,7934,8469,-535,-6.7%
Mallee,70+,19501,20036,-535,-2.7%
Hughes,55-59,8601,9137,-536,-6.2%
Isaacs,65-69,6403,6940,-537,-8.4%
Chisholm,60-64,6154,6691,-537,-8.7%
Warringah,40-44,10117,10655,-538,-5.3%
Dunkley,60-64,7610,8150,-540,-7.1%
Bradfield,30-34,5883,6425,-542,-9.2%
Greenway,60-64,6415,6957,-542,-8.4%
Scullin,35-39,9676,10218,-542,-5.6%
Macarthur,65-69,6437,6980,-543,-8.4%
Macarthur,35-39,9850,10394,-544,-5.5%
Dunkley,55-59,8480,9026,-546,-6.4%
Adelaide,60-64,8043,8590,-547,-6.8%
Grayndler,55-59,7250,7797,-547,-7.6%
Corangamite,65-69,8567,9116,-549,-6.4%
Parramatta,60-64,6342,6891,-549,-8.7%
Groom,70+,16542,17091,-549,-3.3%
Fadden,60-64,7770,8319,-549,-7.1%
Perth,35-39,9261,9811,-550,-5.9%
Wills,60-64,5798,6349,-551,-9.5%
Maribyrnong,55-59,8731,9282,-551,-6.3%
Bennelong,65-69,6078,6632,-554,-9.1%
Moreton,30-34,8895,9452,-557,-6.3%
Robertson,20-24,7621,8178,-557,-7.3%
Tangney,30-34,5368,5927,-559,-10.4%
Sydney,45-49,9001,9560,-559,-6.2%
Sturt,55-59,8132,8691,-559,-6.9%
Flinders,65-69,10251,10811,-560,-5.5%
Gorton,60-64,7792,8352,-560,-7.2%
Kingston,65-69,7830,8391,-561,-7.2%
Whitlam,65-69,8329,8891,-562,-6.7%
Hunter,60-64,8897,9459,-562,-6.3%
Dobell,25-29,8218,8781,-563,-6.9%
Mackellar,30-34,6432,6997,-565,-8.8%
Macarthur,60-64,7625,8191,-566,-7.4%
Mitchell,25-29,6541,7110,-569,-8.7%
Eden-Monaro,60-64,9814,10383,-569,-5.8%
Higgins,35-39,8663,9232,-569,-6.6%
Menzies,65-69,6606,7176,-570,-8.6%
Flinders,55-59,9915,10485,-570,-5.8%
Banks,55-59,8838,9409,-571,-6.5%
Calwell,35-39,8473,9045,-572,-6.8%
Wentworth,60-64,5832,6405,-573,-9.8%
Isaacs,60-64,7254,7827,-573,-7.9%
Scullin,55-59,9012,9585,-573,-6.4%
Chifley,60-64,6771,7345,-574,-8.5%
Wills,70+,15140,15714,-574,-3.8%
Newcastle,60-64,7844,8421,-577,-7.4%
Wannon,20-24,6773,7351,-578,-8.5%
Jagajaga,30-34,7462,8040,-578,-7.7%
Kooyong,55-59,7981,8564,-583,-7.3%
Pearce,55-59,7949,8532,-583,-7.3%
Greenway,55-59,7623,8206,-583,-7.6%
Corio,60-64,8455,9039,-584,-6.9%
Boothby,25-29,7054,7639,-585,-8.3%
Menzies,30-34,5496,6081,-585,-10.6%
Gilmore,60-64,11341,11926,-585,-5.2%
Newcastle,70+,15494,16082,-588,-3.8%
Cowper,60-64,10965,11555,-590,-5.4%
McMahon,60-64,7344,7935,-591,-8.0%
North Sydney,35-39,10502,11094,-592,-5.6%
Bennelong,35-39,8850,9443,-593,-6.7%
Bowman,55-59,9329,9924,-595,-6.4%
Werriwa,65-69,5420,6016,-596,-11.0%
Kingsford Smith,55-59,7693,8291,-598,-7.8%
Holt,55-59,9261,9863,-602,-6.5%
Boothby,60-64,8269,8871,-602,-7.3%
Mitchell,55-59,8027,8630,-603,-7.5%
Ryan,45-49,9395,9999,-604,-6.4%
Murray,20-24,7014,7619,-605,-8.6%
Canberra,35-39,11538,12144,-606,-5.2%
Kingsford Smith,35-39,10251,10858,-607,-5.9%
Canberra,65-69,9009,9617,-608,-6.8%
Ryan,55-59,7596,8204,-608,-8.0%
La Trobe,25-29,7974,8582,-608,-7.6%
Fowler,70+,12967,13576,-609,-4.7%
Tangney,65-69,6790,7401,-611,-9.0%
Boothby,65-69,7890,8502,-612,-7.8%
Gellibrand,60-64,6687,7299,-612,-9.2%
Watson,65-69,5656,6269,-613,-10.8%
Menzies,55-59,8286,8899,-613,-7.4%
Curtin,65-69,6212,6826,-614,-9.9%
Stirling,60-64,6609,7223,-614,-9.3%
Batman,35-39,10482,11098,-616,-5.9%
Blair,70+,12395,13012,-617,-5.0%
Goldstein,30-34,5924,6542,-618,-10.4%
Maribyrnong,60-64,7683,8304,-621,-8.1%
Aston,55-59,8224,8845,-621,-7.5%
Werriwa,55-59,9087,9708,-621,-6.8%
Batman,60-64,6121,6743,-622,-10.2%
Fisher,60-64,7924,8546,-622,-7.8%
Griffith,35-39,10533,11155,-622,-5.9%
Barton,45-49,9323,9946,-623,-6.7%
Canning,55-59,8275,8898,-623,-7.5%
Fairfax,55-59,9503,10128,-625,-6.6%
Macquarie,55-59,9429,10055,-626,-6.6%
Bradfield,20-24,8044,8672,-628,-7.8%
Aston,60-64,7197,7827,-630,-8.8%
Batman,70+,14842,15473,-631,-4.3%
Cook,60-64,7274,7906,-632,-8.7%
Cunningham,55-59,9066,9699,-633,-7.0%
Fairfax,65-69,8676,9309,-633,-7.3%
Page,70+,22020,22654,-634,-2.9%
Bowman,65-69,7984,8619,-635,-8.0%
Aston,65-69,6117,6753,-636,-10.4%
Barton,35-39,9397,10033,-636,-6.8%
Herbert,70+,11003,11640,-637,-5.8%
Chifley,35-39,9756,10393,-637,-6.5%
Bowman,60-64,8448,9088,-640,-7.6%
Fremantle,60-64,6822,7465,-643,-9.4%
Curtin,30-34,7133,7778,-645,-9.0%
McEwen,60-64,8837,9482,-645,-7.3%
Cunningham,60-64,7792,8439,-647,-8.3%
Wills,30-34,13204,13852,-648,-4.9%
Barton,30-34,9908,10556,-648,-6.5%
Fenner,55-59,9110,9760,-650,-7.1%
Fairfax,60-64,8924,9574,-650,-7.3%
Fremantle,65-69,5860,6511,-651,-11.1%
Wentworth,55-59,6806,7458,-652,-9.6%
Kooyong,30-34,6539,7192,-653,-10.0%
Barton,65-69,6044,6697,-653,-10.8%
Isaacs,55-59,8252,8911,-659,-8.0%
New England,70+,19978,20638,-660,-3.3%
Holt,65-69,5939,6600,-661,-11.1%
Fremantle,55-59,7873,8535,-662,-8.4%
Shortland,60-64,8593,9255,-662,-7.7%
Moreton,70+,12270,12934,-664,-5.4%
Griffith,70+,9767,10431,-664,-6.8%
Canberra,60-64,9925,10589,-664,-6.7%
Blaxland,60-64,6887,7554,-667,-9.7%
Sturt,60-64,7128,7795,-667,-9.4%
Burt,55-59,7170,7838,-668,-9.3%
Lalor,55-59,8833,9504,-671,-7.6%
Goldstein,55-59,9095,9767,-672,-7.4%
Fowler,65-69,6658,7331,-673,-10.1%
Gorton,65-69,6456,7134,-678,-10.5%
Werriwa,60-64,7013,7692,-679,-9.7%
Hume,55-59,8932,9614,-682,-7.6%
Lalor,60-64,7030,7717,-687,-9.8%
Mackellar,20-24,7218,7911,-693,-9.6%
Menzies,25-29,6039,6733,-694,-11.5%
Scullin,60-64,7529,8224,-695,-9.2%
North Sydney,60-64,6823,7519,-696,-10.2%
Kingston,60-64,8172,8868,-696,-8.5%
Wakefield,60-64,7914,8612,-698,-8.8%
Mayo,60-64,9560,10258,-698,-7.3%
Brand,55-59,7232,7931,-699,-9.7%
Fenner,60-64,7735,8434,-699,-9.0%
Makin,60-64,7486,8186,-700,-9.4%
Hunter,70+,18084,18789,-705,-3.9%
Menzies,60-64,6931,7638,-707,-10.2%
McEwen,55-59,10521,11228,-707,-6.7%
Fenner,40-44,13764,14473,-709,-5.2%
Lilley,70+,15504,16213,-709,-4.6%
Barton,55-59,7787,8499,-712,-9.1%
Ryan,25-29,8367,9080,-713,-8.5%
Holt,35-39,12147,12865,-718,-5.9%
Makin,55-59,8261,8982,-721,-8.7%
Riverina,70+,19959,20682,-723,-3.6%
Reid,60-64,6716,7440,-724,-10.8%
Mitchell,60-64,6818,7543,-725,-10.6%
Cowan,60-64,6161,6888,-727,-11.8%
Forrest,60-64,8377,9104,-727,-8.7%
Canberra,55-59,11847,12575,-728,-6.1%
Watson,60-64,6807,7536,-729,-10.7%
Port Adelaide,60-64,8042,8776,-734,-9.1%
Fowler,60-64,8122,8859,-737,-9.1%
Jagajaga,60-64,7672,8414,-742,-9.7%
Bradfield,60-64,6704,7447,-743,-11.1%
La Trobe,65-69,5995,6739,-744,-12.4%
Whitlam,55-59,9247,9994,-747,-8.1%
Tangney,60-64,7545,8294,-749,-9.9%
Tangney,25-29,5833,6587,-754,-12.9%
Wentworth,70+,14047,14805,-758,-5.4%
Calwell,55-59,9177,9937,-760,-8.3%
Denison,70+,11370,12132,-762,-6.7%
Hughes,60-64,7243,8005,-762,-10.5%
Mackellar,45-49,10004,10769,-765,-7.7%
Sydney,70+,8433,9198,-765,-9.1%
Moore,30-34,6382,7148,-766,-12.0%
Grayndler,45-49,9890,10657,-767,-7.8%
Banks,60-64,7240,8008,-768,-10.6%
Wentworth,45-49,8807,9578,-771,-8.7%
Barton,60-64,6747,7523,-776,-11.5%
Curtin,60-64,6904,7682,-778,-11.3%
Wills,35-39,11816,12600,-784,-6.6%
Warringah,55-59,7665,8458,-793,-10.3%
Warringah,35-39,9012,9807,-795,-8.8%
Warringah,60-64,6260,7058,-798,-12.8%
Whitlam,60-64,8273,9074,-801,-9.7%
Bennelong,60-64,7137,7946,-809,-11.3%
Berowra,55-59,9319,10129,-810,-8.7%
Werriwa,70+,9789,10602,-813,-8.3%
Fenner,45-49,12207,13022,-815,-6.7%
Corangamite,60-64,9024,9840,-816,-9.0%
Mackellar,60-64,7503,8319,-816,-10.9%
Flinders,60-64,9806,10627,-821,-8.4%
Moore,55-59,9223,10047,-824,-8.9%
Holt,60-64,7326,8152,-826,-11.3%
Warringah,45-49,9838,10666,-828,-8.4%
Robertson,60-64,8284,9113,-829,-10.0%
Moncrieff,70+,17877,18713,-836,-4.7%
Wannon,70+,18677,19528,-851,-4.6%
Moore,65-69,6834,7685,-851,-12.5%
Melbourne,35-39,12275,13128,-853,-7.0%
Mitchell,45-49,10169,11022,-853,-8.4%
Kooyong,60-64,6734,7588,-854,-12.7%
Goldstein,60-64,7642,8497,-855,-11.2%
La Trobe,55-59,8830,9686,-856,-9.7%
Murray,70+,20051,20908,-857,-4.3%
Chifley,70+,10267,11133,-866,-8.4%
Adelaide,70+,15397,16268,-871,-5.7%
Calare,70+,18793,19667,-874,-4.7%
Bass,70+,12017,12891,-874,-7.3%
Casey,60-64,7525,8401,-876,-11.6%
La Trobe,60-64,7143,8020,-877,-12.3%
Berowra,60-64,7678,8556,-878,-11.4%
McPherson,70+,16441,17326,-885,-5.4%
Calwell,60-64,7339,8230,-891,-12.1%
Melbourne Ports,70+,11467,12367,-900,-7.9%
Rankin,70+,9663,10570,-907,-9.4%
Barton,70+,15619,16528,-909,-5.8%
Grayndler,70+,10462,11375,-913,-8.7%
Grayndler,35-39,11129,12049,-920,-8.3%
Wentworth,30-34,10801,11722,-921,-8.5%
Richmond,70+,22909,23832,-923,-4.0%
Fremantle,70+,11869,12808,-939,-7.9%
Wentworth,40-44,9325,10266,-941,-10.1%
Bradfield,55-59,8323,9271,-948,-11.4%
Mackellar,55-59,8567,9517,-950,-11.1%
Scullin,70+,13063,14021,-958,-7.3%
Mackellar,25-29,5764,6726,-962,-16.7%
Goldstein,25-29,5571,6537,-966,-17.3%
Oxley,70+,9379,10347,-968,-10.3%
Moore,25-29,6357,7326,-969,-15.2%
Calwell,30-34,8628,9604,-976,-11.3%
Dobell,70+,19598,20584,-986,-5.0%
Blaxland,70+,13011,14011,-1000,-7.7%
Gellibrand,70+,14056,15060,-1004,-7.1%
Reid,70+,13657,14661,-1004,-7.4%
Forde,70+,11517,12524,-1007,-8.7%
Isaacs,70+,14067,15084,-1017,-7.2%
Bonner,70+,13845,14876,-1031,-7.4%
Watson,70+,14061,15093,-1032,-7.3%
O'Connor,70+,15385,16420,-1035,-6.7%
Lalor,35-39,15884,16946,-1062,-6.7%
Holt,70+,10412,11475,-1063,-10.2%
Braddon,70+,12484,13548,-1064,-8.5%
Lalor,70+,9191,10265,-1074,-11.7%
Wright,70+,12689,13776,-1087,-8.6%
Port Adelaide,70+,14490,15578,-1088,-7.5%
Hughes,70+,12594,13683,-1089,-8.6%
Cunningham,70+,17330,18432,-1102,-6.4%
Bennelong,70+,14851,15964,-1113,-7.5%
Hume,70+,14014,15131,-1117,-8.0%
Moore,60-64,7934,9066,-1132,-14.3%
Ballarat,70+,16518,17651,-1133,-6.9%
Berowra,25-29,5698,6842,-1144,-20.1%
Curtin,70+,15324,16473,-1149,-7.5%
Fenner,35-39,14884,16038,-1154,-7.8%
Brand,70+,11144,12306,-1162,-10.4%
Ryan,70+,12603,13770,-1167,-9.3%
Chisholm,70+,17382,18552,-1170,-6.7%
Greenway,70+,9015,10187,-1172,-13.0%
Lindsay,70+,11090,12265,-1175,-10.6%
Cowper,70+,25482,26662,-1180,-4.6%
Barker,70+,19422,20609,-1187,-6.1%
Bradfield,25-29,5384,6579,-1195,-22.2%
Kooyong,70+,15167,16372,-1205,-7.9%
Petrie,70+,17036,18245,-1209,-7.1%
Cowan,70+,9694,10907,-1213,-12.5%
Deakin,70+,16855,18072,-1217,-7.2%
McMahon,70+,12341,13570,-1229,-10.0%
Aston,70+,11669,12902,-1233,-10.6%
Pearce,70+,10630,11865,-1235,-11.6%
Stirling,70+,14609,15849,-1240,-8.5%
McEwen,70+,12226,13467,-1241,-10.1%
Gorton,70+,8652,9902,-1250,-14.4%
Fisher,70+,18991,20250,-1259,-6.6%
Franklin,70+,12329,13596,-1267,-10.3%
Higgins,70+,14342,15614,-1272,-8.9%
Grey,70+,18664,19939,-1275,-6.8%
Bendigo,70+,17764,19041,-1277,-7.2%
Dickson,70+,10207,11489,-1282,-12.6%
Eden-Monaro,70+,16553,17836,-1283,-7.7%
Gippsland,70+,18843,20136,-1293,-6.9%
Tangney,70+,14754,16049,-1295,-8.8%
Bradfield,70+,17569,18867,-1298,-7.4%
Sturt,70+,20063,21367,-1304,-6.5%
Jagajaga,70+,14288,15597,-1309,-9.2%
North Sydney,70+,14163,15474,-1311,-9.3%
Forrest,70+,14549,15861,-1312,-9.0%
Banks,70+,15874,17188,-1314,-8.3%
Menzies,70+,17773,19100,-1327,-7.5%
Indi,70+,18099,19443,-1344,-7.4%
Bruce,70+,16768,18114,-1346,-8.0%
Macarthur,70+,9386,10740,-1354,-14.4%
Wakefield,70+,14916,16272,-1356,-9.1%
Fadden,70+,15909,17265,-1356,-8.5%
Fairfax,70+,18038,19407,-1369,-7.6%
Macquarie,70+,14063,15440,-1377,-9.8%
Berowra,70+,14934,16316,-1382,-9.3%
Lyons,70+,12260,13647,-1387,-11.3%
Burt,70+,9890,11279,-1389,-14.0%
Wide Bay,70+,19873,21273,-1400,-7.0%
Longman,70+,16106,17515,-1409,-8.7%
Bowman,70+,15599,17021,-1422,-9.1%
La Trobe,70+,10378,11808,-1430,-13.8%
Paterson,70+,17948,19409,-1461,-8.1%
Corangamite,70+,17484,18947,-1463,-8.4%
Mackellar,70+,18258,19737,-1479,-8.1%
Hotham,70+,16002,17483,-1481,-9.3%
Warringah,70+,13994,15490,-1496,-10.7%
Wentworth,35-39,10040,11543,-1503,-15.0%
Maribyrnong,70+,16186,17689,-1503,-9.3%
Kingsford Smith,70+,14835,16340,-1505,-10.1%
Calwell,70+,11073,12583,-1510,-13.6%
Corio,70+,17439,18970,-1531,-8.8%
Hasluck,70+,12462,14030,-1568,-12.6%
Boothby,70+,18083,19664,-1581,-8.7%
Fenner,70+,12716,14326,-1610,-12.7%
Hinkler,70+,22524,24141,-1617,-7.2%
Goldstein,70+,16840,18471,-1631,-9.7%
Mitchell,70+,11914,13568,-1654,-13.9%
Hindmarsh,70+,20305,21970,-1665,-8.2%
Sydney,35-39,12833,14512,-1679,-13.1%
Canberra,70+,17281,18970,-1689,-9.8%
Kingston,70+,13764,15458,-1694,-12.3%
Moore,70+,9909,11657,-1748,-17.6%
McMillan,70+,19133,20933,-1800,-9.4%
Casey,70+,12755,14582,-1827,-14.3%
Cook,70+,17413,19240,-1827,-10.5%
Shortland,70+,19793,21624,-1831,-9.2%
Robertson,70+,20010,21897,-1887,-9.4%
Canning,70+,17127,19054,-1927,-11.3%
Lyne,70+,25565,27613,-2048,-8.0%
Makin,70+,14859,16945,-2086,-14.0%
Dunkley,70+,16944,19034,-2090,-12.3%
Gilmore,70+,25183,27305,-2122,-8.4%
Whitlam,70+,18826,20995,-2169,-11.5%
Mayo,70+,18651,20979,-2328,-12.5%
Flinders,70+,22069,24766,-2697,-12.2%